TRANSACTION TYPE,PAID IN,,,,,
SEND MONEY:,0,"464,868.00",,,,
RECEIVED MONEY:,"572,293.00",0,,,,
AGENT DEPOSIT:,"179,370.00",0,,,,
AGENT WITHDRAWAL:,0,"86,873.00",,,,
LIPA NA M-PESA (PAYBILL):,0,"258,081.00",,,,
LIPA NA M-PESA (BUY GOODS):,0,"96,431.20",,,,
OTHERS:,"440,058.00","263,957.00",,,,
TOTAL:,"1,191,721.00","1,170,210.20",,,,
Receipt No.,Completion Time,Details,Transaction Status,Paid In,Withdrawn,Balance
RAA53ADSLZ,1/10/2023 12:28,,Completed,,-180,220.9
RAA939H40V,1/10/2023 12:17,,Completed,,-300,400.9
RA87YH2UL3,1/8/2023 18:56,,Completed,,-6,220.9
RA87YH2UL3,1/8/2023 18:56,,Completed,,-200,226.9
RA87YG1OXT,1/8/2023 18:47,,Completed,,-12,426.9
RA87YG1OXT,1/8/2023 18:47,,Completed,,-600,438.9
RA86YFZ4WG,1/8/2023 18:46,,Completed,"1,000.00",,"1,038.90"
RA74W6O29Q,1/7/2023 19:02,,Completed,,-6,38.9
RA74W6O29Q,1/7/2023 19:02,,Completed,,-310,44.9
RA70W4FGA8,1/7/2023 18:43,,Completed,300,,354.9
RA79V3ELG9,1/7/2023 12:14,,Completed,,-6,54.9
RA79V3ELG9,1/7/2023 12:14,,Completed,,-320,60.9
RA73V1NP5X,1/7/2023 11:55,,Completed,,-10,380.9
RA79V1CJBZ,1/7/2023 11:51,,Completed,,-10,390.9
RA74V0ZN5A,1/7/2023 11:47,,Completed,400,,400.9
RA62TR0LWS,1/6/2023 19:27,,Completed,,-9,0.9
RA61TQXGFR,1/6/2023 19:27,,Completed,5,,9.9
RA69S8FQWP,1/6/2023 9:56,,Completed,,-5,4.9
RA60RYULVM,1/6/2023 7:44,,Completed,,-35,9.9
RA51R0OZT1,1/5/2023 18:22,,Completed,,-4,44.9
RA51R0OZT1,1/5/2023 18:22,,Completed,,-300,48.9
RA50QLA3CI,1/5/2023 15:47,,Completed,,-10,348.9
RA52QKZNCQ,1/5/2023 15:44,,Completed,,-28,358.9
RA52QKZNCQ,1/5/2023 15:44,,Completed,,"-1,125.00",386.9
RA50QIGD1G,1/5/2023 15:16,,Completed,"1,500.00",,"1,511.90"
RA57Q09P89,1/5/2023 11:48,,Completed,,-20,11.9
Statement Verification Code,"To verify the validity of this M-PESA statement dial *334#, select My account and follow theprompts to enter the code.",,,,,
,,,,,,
LLHKTUZR,,,,,,
Receipt No.,Completion Time,,Transaction Status,Paid In,Withdrawn,Balance
RA41O89UMN,1/4/2023 16:21,,Completed,0,,31.9
RA42NXA6Y6,1/4/2023 14:17,,Completed,,-10,31.9
RA44NPCHA2,1/4/2023 12:48,,Completed,,-27,41.9
RA44NPCHA2,1/4/2023 12:48,,Completed,,-450,68.9
RA45NP95VR,1/4/2023 12:47,,Completed,500,,518.9
RA46NP39SS,1/4/2023 12:45,,Completed,,-27,18.9
RA46NP39SS,1/4/2023 12:45,,Completed,,-250,45.9
RA44NOY6LQ,1/4/2023 12:43,,Completed,,-12,295.9
RA44NOY6LQ,1/4/2023 12:43,,Completed,,-610,307.9
RA49NODK5J,1/4/2023 12:36,,Completed,900,,917.9
RA49NMS0C9,1/4/2023 12:18,,Completed,,-10,17.9
RA38M75L80,1/3/2023 18:37,,Completed,,-530,27.9
RA33M69EKH,1/3/2023 18:29,,Completed,,-300,557.9
RA30M4K2XE,1/3/2023 18:14,,Completed,850,,857.9
RA34LWV4EW,1/3/2023 16:59,,Completed,,-10,7.9
RA31LWU0PN,1/3/2023 16:59,,Completed,15,,17.9
RA39L7A9QB,1/3/2023 12:10,,Completed,,-10,2.9
RA14I0CBH6,1/1/2023 20:34,,Completed,,-10,12.9
RA19I0BADH,1/1/2023 20:34,,Completed,10,,22.9
RA19HTJORD,1/1/2023 19:25,,Completed,,"-2,999.00",12.9
RA18HTG3K8,1/1/2023 19:24,,Completed,"3,000.00",,"3,011.90"
RA12HLOZGY,1/1/2023 18:05,,Completed,10,,11.9
RA17GL1NQ5,1/1/2023 10:40,,Completed,,-100,1.9
RA11GKZ5X7,1/1/2023 10:39,,Completed,,-100,101.9
RA13GKXPAT,1/1/2023 10:39,,Completed,200,,201.9
RA15GBB0YX,1/1/2023 8:26,,Completed,,-10,1.9
QLV1FO5CR3,12/31/2022 21:13,,Completed,,"-6,700.00",11.9
QLV3FO2NB3,12/31/2022 21:12,,Completed,"6,700.00",,"6,711.90"
QLV8FNYBJ6,12/31/2022 21:11,,Completed,,-5,11.9
QLV1FNVHF5,12/31/2022 21:10,,Completed,,-130,16.9
QLV5FI58KJ,12/31/2022 20:18,,Completed,,-10,146.9
QLV6F2T30C,12/31/2022 18:25,,Completed,,-6,156.9
QLV6F2T30C,12/31/2022 18:25,,Completed,,-350,162.9
QLV6EZCVJU,12/31/2022 17:57,,Completed,500,,512.9
QLV9EX8W0H,12/31/2022 17:39,,Completed,,-240,12.9
QLV1EQWJ2D,12/31/2022 16:42,,Completed,,-28,252.9
QLV1EQWJ2D,12/31/2022 16:42,,Completed,,"-1,500.00",280.9
QLV2ENL1I0,12/31/2022 16:10,,Completed,"1,500.00",,"1,780.90"
QLV4DXHKHY,12/31/2022 11:38,,Completed,,-20,280.9
QLV7DHOXPZ,12/31/2022 8:27,,Completed,,-23,300.9
QLV7DHOXPZ,12/31/2022 8:27,,Completed,,-500,323.9
QLV8DHMMTA,12/31/2022 8:26,,Completed,500,,823.9
QLU4CY1KKW,12/30/2022 20:47,,Completed,,-75,323.9
QLU4CY1KKW,12/30/2022 20:47,,Completed,,"-5,500.00",398.9
Statement Verification Code,"To verify the validity of this M-PESA statement dial *334#, select My account and follow theprompts to enter the code.",,,,,
,,,,,,
LLHKTUZR,,,,,,
Receipt No.,Completion Time,,Transaction Status,Paid In,Withdrawn,Balance
QLU7CHE9ZF,12/30/2022 18:30,,Completed,,-2,"5,898.90"
QLU7CHE9ZF,12/30/2022 18:30,,Completed,,-100,"5,900.90"
QLU0CAJS7E,12/30/2022 17:25,,Completed,,-6,"6,000.90"
QLU0CAJS7E,12/30/2022 17:25,,Completed,,-200,"6,006.90"
QLU5BS9EPN,12/30/2022 14:04,,Completed,,-28,"6,206.90"
QLU5BS9EPN,12/30/2022 14:04,,Completed,,"-1,200.00","6,234.90"
QLU2BQPQ1S,12/30/2022 13:46,,Completed,,"-1,250.00","7,434.90"
QLU1BQLQ0H,12/30/2022 13:45,,Completed,,-22,"8,684.90"
QLU1BQLQ0H,12/30/2022 13:45,,Completed,,"-1,430.00","8,706.90"
QLU1BQIABP,12/30/2022 13:44,,Completed,,-100,"10,136.90"
QLU2BQC6ZC,12/30/2022 13:42,,Completed,,-22,"10,236.90"
QLU2BQC6ZC,12/30/2022 13:42,,Completed,,"-1,020.00","10,258.90"
QLU5BLIKNH,12/30/2022 12:47,,Completed,,-20,"11,278.90"
QLU9BKU1HF,12/30/2022 12:39,,Completed,,-6,"11,298.90"
QLU9BKU1HF,12/30/2022 12:39,,Completed,,-400,"11,304.90"
QLU4BJYWGC,12/30/2022 12:29,,Completed,,-700,"11,704.90"
QLU6BIWUZA,12/30/2022 12:17,,Completed,,-12,"12,404.90"
QLU6BIWUZA,12/30/2022 12:17,,Completed,,-700,"12,416.90"
QLT7ARBJP5,12/29/2022 23:29,,Completed,,-2,"13,116.90"
QLT7ARBJP5,12/29/2022 23:29,,Completed,,-100,"13,118.90"
QLT09M6DXM,12/29/2022 15:41,,Completed,,-23,"13,218.90"
QLT09M6DXM,12/29/2022 15:41,,Completed,,-500,"13,241.90"
QLT69DT7WQ,12/29/2022 14:04,,Completed,,-15,"13,741.90"
QLT89219EI,12/29/2022 11:48,,Completed,,-2,"13,756.90"
QLT89219EI,12/29/2022 11:48,,Completed,,-100,"13,758.90"
QLT991B09J,12/29/2022 11:39,,Completed,,-70,"13,858.90"
QLT1911ZX7,12/29/2022 11:36,,Completed,,-70,"13,928.90"
QLT790NUIH,12/29/2022 11:32,,Completed,,-12,"13,998.90"
QLT790NUIH,12/29/2022 11:32,,Completed,,"-1,000.00","14,010.90"
QLT590LMC1,12/29/2022 11:31,,Completed,"1,000.00",,"15,010.90"
QLT28ZHAYS,12/29/2022 11:17,,Completed,"13,200.00",,"14,010.90"
QLS57Q92LF,12/28/2022 18:43,,Completed,770,,810.9
QLR15BOHQN,12/27/2022 17:55,,Completed,,-23,40.9
QLR15BOHQN,12/27/2022 17:55,,Completed,,-150,63.9
QLR25BKPO2,12/27/2022 17:53,,Completed,200,,213.9
QLR45B9NXI,12/27/2022 17:50,,Completed,,-5,13.9
QLR8599V90,12/27/2022 17:28,,Completed,,-27,18.9
QLR8599V90,12/27/2022 17:28,,Completed,,-150,45.9
QLR458YOQM,12/27/2022 17:24,,Completed,,-140,195.9
Statement Verification Code,"To verify the validity of this M-PESA statement dial *334#, select My account and follow theprompts to enter the code.",,,,,
,,,,,,
LLHKTUZR,,,,,,
Receipt No.,Completion Time,,Transaction Status,Paid In,Withdrawn,Balance
QLR758TMSP,12/27/2022 17:23,,Completed,,-6,335.9
QLR758TMSP,12/27/2022 17:23,,Completed,,-210,341.9
QLR5566HWT,12/27/2022 16:52,,Completed,,-22,551.9
QLR5566HWT,12/27/2022 16:52,,Completed,,"-1,500.00",573.9
QLR04GSN7C,12/27/2022 11:29,,Completed,,-95,"2,073.90"
QLR24FYBF8,12/27/2022 11:19,,Completed,,-10,"2,168.90"
QLQ4253T28,12/26/2022 10:17,,Completed,"2,000.00",,"2,178.90"
QLP7ZAOI2N,12/25/2022 12:41,,Completed,,-50,178.9
QLO1XHTV0L,12/24/2022 18:31,,Completed,,-6,228.9
QLO1XHTV0L,12/24/2022 18:31,,Completed,,-230,234.9
QLO8WYWO56,12/24/2022 15:53,,Completed,,-12,464.9
QLO8WYWO56,12/24/2022 15:53,,Completed,,-700,476.9
QLO5WVQ2SB,12/24/2022 15:24,,Completed,"1,000.00",,"1,176.90"
QLO8WVMHSI,12/24/2022 15:23,,Completed,,-5,176.9
QLO1WREWZ1,12/24/2022 14:43,,Completed,,-35,181.9
QLO1WNYO4T,12/24/2022 14:11,,Completed,,-15,216.9
QLN6UL3RDW,12/23/2022 18:43,,Completed,,-500,231.9
QLN5TR7QB5,12/23/2022 14:15,,Completed,,-35,731.9
QLN7SS6CDP,12/23/2022 8:07,,Completed,,-20,766.9
QLM2S3DO8Q,12/22/2022 20:09,,Completed,,-10,786.9
QLM0QYWYWC,12/22/2022 14:10,,Completed,,-5,796.9
QLM7QYKKVL,12/22/2022 14:06,,Completed,,-135,801.9
QLM4QU2LH8,12/22/2022 13:21,,Completed,,-35,936.9
QLL2PBKIMG,12/21/2022 19:48,,Completed,,-10,971.9
QLK6MOIZVQ,12/20/2022 20:06,,Completed,,-10,"1,061.90"
QLK7MFZ6BN,12/20/2022 19:05,,Completed,,-135,"1,071.90"
QLK8ME9OYA,12/20/2022 18:53,,Completed,,-960,"1,206.90"
QLK4MDJR2Q,12/20/2022 18:47,,Completed,"2,000.00",,"2,166.90"
QLK6MDG0JQ,12/20/2022 18:47,,Completed,,-10,166.9
QLK7MBE91Z,12/20/2022 18:31,,Completed,,"-1,200.00",176.9
QLK6LRUEL8,12/20/2022 15:24,,Completed,,-10,"1,376.90"
QLK6LRUEL8,12/20/2022 15:24,,Completed,,-100,"1,386.90"
QLK2L2ZXWO,12/20/2022 10:59,,Completed,,-45,"1,486.90"
QLK6KP7NJM,12/20/2022 8:17,,Completed,,-10,"1,531.90"
QLK3KKU143,12/20/2022 7:07,,Completed,,-35,"1,541.90"
QLJ0JYKWXC,12/19/2022 19:41,,Completed,,-45,"1,576.90"
QLJ4JY0CFE,12/19/2022 19:37,,Completed,,-65,"1,621.90"
QLJ6JHWBGQ,12/19/2022 17:33,,Completed,,-75,"1,686.90"
QLJ2JAOYPK,12/19/2022 16:23,,Completed,,-20,"1,761.90"
QLJ0IPID8S,12/19/2022 12:36,,Completed,,-35,"1,781.90"
QLJ8IOMOZA,12/19/2022 12:26,,Completed,,-10,"1,816.90"
QLJ5I6KHYZ,12/19/2022 9:01,,Completed,"1,000.00",,"1,826.90"
QLI2GCSPJC,12/18/2022 13:31,,Completed,,-20,826.9
QLI4GCP4HA,12/18/2022 13:30,,Completed,,-10,846.9
QLD62W74LU,12/13/2022 13:33,,Completed,,-10,"3,206.90"
Statement Verification Code,"To verify the validity of this M-PESA statement dial *334#, select My account and follow theprompts to enter the code.",,,,,
,,,,,,
LLHKTUZR,,,,,,
Receipt No.,Completion Time,,Transaction Status,Paid In,Withdrawn,Balance
QLD82UZJ02,12/13/2022 13:20,,Completed,,-100,"3,216.90"
QLD52SB9X7,12/13/2022 12:52,,Completed,,-80,"3,316.90"
QLD62HPMUK,12/13/2022 10:56,,Completed,,-100,"3,396.90"
QLD62HL7GS,12/13/2022 10:55,,Completed,55,,"3,496.90"
QLD3229V8V,12/13/2022 7:41,,Completed,,-130,"3,441.90"
QLD51XMKYF,12/13/2022 4:29,,Completed,20,,"3,571.90"
QLD41WYVME,12/13/2022 1:44,,Completed,20,,"3,551.90"
QLC41J0YUK,12/12/2022 20:17,,Completed,,-6,"3,531.90"
QLC41J0YUK,12/12/2022 20:17,,Completed,,-500,"3,537.90"
QLC01DFP88,12/12/2022 19:32,,Completed,,-35,"4,037.90"
QLC8ZGZEBW,12/12/2022 14:29,,Completed,,-50,"4,072.90"
QLC4Z6HJHA,12/12/2022 12:39,,Completed,,-35,"4,122.90"
QLC5YXBSJF,12/12/2022 10:57,,Completed,,-20,"4,157.90"
QLC3YPJPYL,12/12/2022 9:27,,Completed,,-30,"4,177.90"
QLB5Y6L71L,12/11/2022 21:51,,Completed,"4,000.00",,"4,207.90"
QLB0XK4E9A,12/11/2022 18:23,,Completed,,-35,207.9
QLB9WVT1VF,12/11/2022 14:19,,Completed,,-55,242.9
QLB5WCP4FR,12/11/2022 10:29,,Completed,,-15,297.9
QLB3WC5A09,12/11/2022 10:22,,Completed,,-20,312.9
QLA9USETDP,12/10/2022 17:22,,Completed,,-70,332.9
QLA0U5EFLK,12/10/2022 13:38,,Completed,,-35,402.9
QLA0TGT61O,12/10/2022 9:18,,Completed,,-20,437.9
QL99RPRFGT,12/9/2022 16:08,,Completed,,-35,457.9
QL96QGQ1HK,12/9/2022 8:23,,Completed,,-25,492.9
QL87P7895D,12/8/2022 18:02,,Completed,,-10,517.9
QL73MWYXH5,12/7/2022 20:44,,Completed,,-35,527.9
QL70MMZSA8,12/7/2022 19:33,,Completed,,-45,562.9
QL78LFEJUO,12/7/2022 13:28,,Completed,,-80,607.9
QL74L87D2S,12/7/2022 12:19,,Completed,,-10,687.9
QL71L1J0DR,12/7/2022 11:12,,Completed,,-254,697.9
QL74KS0V3W,12/7/2022 9:32,,Completed,,-20,951.9
QL79KK443D,12/7/2022 7:59,,Completed,,-10,971.9
QL67K1CL03,12/6/2022 21:09,,Completed,,-35,981.9
QL66IZT8R4,12/6/2022 16:31,,Completed,,-10,"1,016.90"
QL61ILDN6Z,12/6/2022 14:15,,Completed,,-20,"1,026.90"
QL60IJYIHY,12/6/2022 14:02,,Completed,,-200,"1,046.90"
QL57GYU15L,12/5/2022 21:01,,Completed,,-35,"1,246.90"
QL52GYRU46,12/5/2022 21:01,,Completed,,-55,"1,281.90"
QL51G9QW9T,12/5/2022 18:18,,Completed,,-5,"1,336.90"
QL53FE3M8B,12/5/2022 14:02,,Completed,,-435,"1,341.90"
QL59EKDKNJ,12/5/2022 9:29,,Completed,,"-5,000.00","1,776.90"
QL53EJWVK7,12/5/2022 9:24,,Completed,"5,000.00",,"6,776.90"
Statement Verification Code,"To verify the validity of this M-PESA statement dial *334#, select My account and follow theprompts to enter the code.",,,,,
,,,,,,
LLHKTUZR,,,,,,
Receipt No.,Completion Time,,Transaction Status,Paid In,Withdrawn,Balance
QL42DHTFO4,12/4/2022 20:05,,Completed,,-35,"1,776.90"
QL47D8YUC5,12/4/2022 19:05,,Completed,,"-2,999.00","1,811.90"
QL41D8TZPV,12/4/2022 19:04,,Completed,"3,000.00",,"4,810.90"
QL45D7COS1,12/4/2022 18:55,,Completed,"1,500.00",,"1,810.90"
QL37AEGHAF,12/3/2022 20:36,,Completed,,-6,310.9
QL37AEGHAF,12/3/2022 20:36,,Completed,,-400,316.9
QL38ADS12E,12/3/2022 20:31,,Completed,400,,716.9
QL32A4S97E,12/3/2022 19:32,,Completed,,-6,316.9
QL32A4S97E,12/3/2022 19:32,,Completed,,-500,322.9
QL34A4MJF4,12/3/2022 19:31,,Completed,500,,822.9
QL32A4HB78,12/3/2022 19:30,,Completed,,-5,322.9
QL359AZPPL,12/3/2022 15:54,,Completed,,-60,327.9
QL339ASCA9,12/3/2022 15:52,,Completed,,-60,387.9
QL3092S7AY,12/3/2022 14:41,,Completed,,-25,447.9
QL308UUR1Y,12/3/2022 13:33,,Completed,,-5,472.9
QL358KTXHD,12/3/2022 12:08,,Completed,,-5,477.9
QL30822PTY,12/3/2022 9:17,,Completed,,-10,482.9
QL337T7HF3,12/3/2022 7:39,,Completed,,-35,492.9
QL387T67JK,12/3/2022 7:39,,Completed,500,,527.9
QL2073J3UI,12/2/2022 20:42,,Completed,,-6,27.9
QL2073J3UI,12/2/2022 20:42,,Completed,,-120,33.9
QL236U1DQR,12/2/2022 19:35,,Completed,,-5,153.9
QL215RM1FB,12/2/2022 14:36,,Completed,,"-1,000.00",158.9
QL24562G3C,12/2/2022 11:19,,Completed,,-5,158.9
QL1843KEKW,12/1/2022 22:33,,Completed,,-35,163.9
QL182HI3XA,12/1/2022 14:27,,Completed,,-50,198.9
QL182CW1PQ,12/1/2022 13:43,,Completed,,-10,248.9
QL14287YU8,12/1/2022 12:58,,Completed,,-10,258.9
QL12218ZEM,12/1/2022 11:47,,Completed,,-10,268.9
QKU9104LV7,11/30/2022 22:17,,Completed,,-35,278.9
QKU2ZRLCD4,11/30/2022 20:40,,Completed,,-105,313.9
QKU4ZESK0C,11/30/2022 19:05,,Completed,,-800,441.9
QKU5ZEL1VN,11/30/2022 19:04,,Completed,800,,"1,241.90"
QKU5Z2UOYP,11/30/2022 17:35,,Completed,,-56,441.9
QKU7Z2SOU3,11/30/2022 17:35,,Completed,"1,000.00",,"3,697.90"
QKU1YU1OQV,11/30/2022 16:11,,Completed,,-15,"1,097.90"
QKU2YTXNF8,11/30/2022 16:10,,Completed,,-60,"1,112.90"
QKU3YEB4NH,11/30/2022 13:16,,Completed,500,,"1,172.90"
QKU1YDK26B,11/30/2022 13:07,,Completed,,-25,672.9
QKU2YAM27W,11/30/2022 12:32,,Completed,,-10,697.9
QKU8XWQQE2,11/30/2022 9:36,,Completed,,-35,707.9
QKT3X10JJV,11/29/2022 19:30,,Completed,,-45,742.9
QKT3WXI84X,11/29/2022 19:04,,Completed,,-35,787.9
QKT4WU4VV6,11/29/2022 18:39,,Completed,,-5,822.9
QKT0W8J4UC,11/29/2022 15:00,,Completed,,-10,827.9
QKT9VXNRX7,11/29/2022 12:50,,Completed,,-70,837.9
Statement Verification Code,"To verify the validity of this M-PESA statement dial *334#, select My account and follow theprompts to enter the code.",,,,,
,,,,,,
LLHKTUZR,,,,,,
Receipt No.,Completion Time,,Transaction Status,Paid In,Withdrawn,Balance
QKT4VSAF3M,11/29/2022 11:42,,Completed,,-10,907.9
QKT4VG58ZO,11/29/2022 8:58,,Completed,,-20,927.9
QKS6UQ7DVE,11/28/2022 19:42,,Completed,,-35,947.9
QKS2UPVVBO,11/28/2022 19:40,,Completed,,-50,982.9
QKS9UAK76B,11/28/2022 17:37,,Completed,,-60,"1,032.90"
QKS2TKH8O4,11/28/2022 12:37,,Completed,,-100,"1,092.90"
QKS4TJH3Q0,11/28/2022 12:25,,Completed,,-10,"1,192.90"
QKS5TFTRMD,11/28/2022 11:38,,Completed,,-10,"1,202.90"
QKQ7QMMTXF,11/26/2022 22:55,,Completed,,-10,"1,212.90"
QKQ0QK1F62,11/26/2022 21:59,,Completed,,-10,"1,222.90"
QKQ8Q43LXQ,11/26/2022 19:20,,Completed,,-65,"1,232.90"
QKQ6P6HZEY,11/26/2022 13:41,,Completed,,-35,"1,297.90"
QKQ1P698FN,11/26/2022 13:38,,Completed,,-70,"1,332.90"
QKQ1OIZ9JV,11/26/2022 8:43,,Completed,,-20,"1,402.90"
QKP5NOI3OD,11/25/2022 19:19,,Completed,,-50,"1,422.90"
QKP1N51B1P,11/25/2022 16:34,,Completed,,-35,"1,472.90"
QKP2MWTG9E,11/25/2022 15:03,,Completed,,-50,"1,507.90"
QKP2M2MKYC,11/25/2022 9:00,,Completed,,-50,"1,557.90"
QKP8M0GR7Q,11/25/2022 8:30,,Completed,,-10,"1,607.90"
QKO8LG3NTG,11/24/2022 20:16,,Completed,,-45,"1,617.90"
QKO6LCFWCY,11/24/2022 19:42,,Completed,,-65,"1,662.90"
QKO9KXKSLR,11/24/2022 17:37,,Completed,,-20,"1,727.90"
QKO9KVKTFJ,11/24/2022 17:16,,Completed,,-35,"1,747.90"
QKO9KP4BVD,11/24/2022 16:04,,Completed,,-20,"1,782.90"
QKO4KFTEOW,11/24/2022 14:13,,Completed,,-10,"1,802.90"
QKO9KBUHVF,11/24/2022 13:25,,Completed,,-6,"1,812.90"
QKO9KBUHVF,11/24/2022 13:25,,Completed,,-120,"1,818.90"
QKO7K7AKM3,11/24/2022 12:29,,Completed,"1,100.00",,"1,938.90"
QKO8K63RCK,11/24/2022 12:14,,Completed,,-12,838.9
QKO8K63RCK,11/24/2022 12:14,,Completed,,"-1,000.00",850.9
QKO0K61YNG,11/24/2022 12:14,,Completed,"1,000.00",,"1,850.90"
QKO5K4WXSN,11/24/2022 11:59,,Completed,,-10,850.9
QKM9FDRKIL,11/22/2022 11:20,,Completed,,-300,860.9
QKM9FBU3NR,11/22/2022 10:55,,Completed,,-10,"1,160.90"
QKM1FB48E9,11/22/2022 10:45,,Completed,"1,000.00",,"1,170.90"
QKM9EUNLV5,11/22/2022 6:03,,Completed,,-10,170.9
QKL3DGGAO9,11/21/2022 14:30,,Completed,,-5,180.9
QKK2C8CRGC,11/20/2022 20:46,,Completed,,-10,185.9
QKK7C7TFQN,11/20/2022 20:40,,Completed,,-5,195.9
QKK5AGJTBP,11/20/2022 6:21,,Completed,,-25,200.9
QKK4AG1G2O,11/20/2022 5:24,,Completed,,-35,225.9
QKJ9A085IX,11/19/2022 20:02,,Completed,,-80,260.9
Statement Verification Code,"To verify the validity of this M-PESA statement dial *334#, select My account and follow theprompts to enter the code.",,,,,
,,,,,,
LLHKTUZR,,,,,,
Receipt No.,Completion Time,,Transaction Status,Paid In,Withdrawn,Balance
QKJ68YHF9S,11/19/2022 13:48,,Completed,,-50,340.9
QKI77MME1B,11/18/2022 19:50,,Completed,,-50,425.9
QKH43RDC7W,11/17/2022 9:09,,Completed,"1,000.00",,"1,105.90"
QKC4RT0O9U,11/12/2022 12:18,,Completed,,-20,706.9
QJ72F85HEI,10/7/2022 13:34,,Completed,,-60,888.9
QJ75F82FT1,10/7/2022 13:33,,Completed,890,,948.9
QJ73F7XEAT,10/7/2022 13:31,,Completed,,-5,58.9
QJ79EN0CX7,10/7/2022 9:05,,Completed,,-20,63.9
QJ64E5XSHM,10/6/2022 21:35,,Completed,,-35,83.9
QJ66DRXMHY,10/6/2022 19:20,,Completed,,-80,118.9
QJ66CS506K,10/6/2022 13:10,,Completed,,-50,198.9
QJ66C7RDQ6,10/6/2022 8:39,,Completed,,-40,248.9
QJ61BZKCJT,10/6/2022 3:27,,Completed,,-35,288.9
QJ57BMCKC5,10/5/2022 20:22,,Completed,,-5,323.9
QJ55BC9T8B,10/5/2022 19:03,,Completed,,-6,328.9
QJ55BC9T8B,10/5/2022 19:03,,Completed,,-400,334.9
QJ52B4R3ZM,10/5/2022 18:05,,Completed,,-5,734.9
QJ50B41BKS,10/5/2022 17:58,,Completed,,"-5,000.00",739.9
QJ55B3WOIR,10/5/2022 17:57,,Completed,"5,000.00",,"5,739.90"
QJ54AGI4RY,10/5/2022 13:33,,Completed,,-10,739.9
QJ55A3AQLP,10/5/2022 10:47,,Completed,,-130,749.9
QJ549T5ESE,10/5/2022 8:27,,Completed,,-40,879.9
QJ479F8IOD,10/4/2022 21:33,,Completed,,-35,919.9
QJ4790KG7P,10/4/2022 19:14,,Completed,,-10,954.9
QJ4790KG7P,10/4/2022 19:14,,Completed,,-100,964.9
QJ43881DBR,10/4/2022 14:27,,Completed,,-10,"1,064.90"
QJ43881DBR,10/4/2022 14:27,,Completed,,-100,"1,074.90"
QJ497V2ULN,10/4/2022 11:47,,Completed,,-5,"1,174.90"
QJ477U5VN1,10/4/2022 11:35,,Completed,,-20,"1,179.90"
QJ487KXKEE,10/4/2022 9:34,,Completed,,-5,"1,199.90"
QJ3371N2DH,10/3/2022 21:19,,Completed,,-35,"1,204.90"
QJ396TYWWL,10/3/2022 19:58,,Completed,,-50,"1,239.90"
QJ376IDG3V,10/3/2022 18:27,,Completed,,-20,"1,289.90"
QJ345WW9UG,10/3/2022 14:32,,Completed,,-50,"1,309.90"
QJ34549B8W,10/3/2022 8:29,,Completed,,-20,"1,359.90"
QJ3551BLMZ,10/3/2022 7:41,,Completed,,-35,"1,379.90"
QJ224UYWQG,10/2/2022 23:19,,Completed,,-5,"1,414.90"
QJ264KU9MG,10/2/2022 20:17,,Completed,,-50,"1,419.90"
QJ213XZQJF,10/2/2022 16:40,,Completed,,-10,"1,469.90"
Statement Verification Code,"To verify the validity of this M-PESA statement dial *334#, select My account and follow theprompts to enter the code.",,,,,
,,,,,,
LLHKTUZR,,,,,,
Receipt No.,Completion Time,,Transaction Status,Paid In,Withdrawn,Balance
QJ263O400A,10/2/2022 14:43,,Completed,,-50,"1,479.90"
QJ283IYHBU,10/2/2022 13:39,,Completed,,-10,"1,529.90"
QJ263ICSMI,10/2/2022 13:31,,Completed,"1,500.00",,"1,539.90"
QJ293C55RR,10/2/2022 12:04,,Completed,,-10,39.9
QJ2531GQOF,10/2/2022 9:24,,Completed,,-10,49.9
QJ242ZVBRI,10/2/2022 8:59,,Completed,,-20,59.9
QJ242W2TJU,10/2/2022 7:55,,Completed,,-10,79.9
QJ15287ZFN,10/1/2022 19:35,,Completed,,-65,89.9
QJ151XBG1D,10/1/2022 18:09,,Completed,,-20,154.9
QJ141AFDUU,10/1/2022 14:06,,Completed,,-50,174.9
QJ1819FP5I,10/1/2022 13:55,,Completed,,-6,224.9
QJ1819FP5I,10/1/2022 13:55,,Completed,,-500,230.9
QJ1614VQFY,10/1/2022 13:04,,Completed,,-20,730.9
QJ11140A9R,10/1/2022 12:54,,Completed,,-10,750.9
QJ10ZYLQ4U,10/1/2022 11:50,,Completed,,-20,760.9
QJ19ZM7BNB,10/1/2022 9:13,,Completed,,-20,780.9
QJ16ZFZOKW,10/1/2022 7:36,,Completed,,"-2,999.00",800.9
QJ15ZFY54R,10/1/2022 7:36,,Completed,"3,000.00",,"3,799.90"
QJ12ZFL9DO,10/1/2022 7:28,,Completed,,-5,799.9
QIU0YS6YYE,9/30/2022 19:36,,Completed,,-10,804.9
QIU8YRB4ES,9/30/2022 19:29,,Completed,,-60,814.9
QIU8YBYPW2,9/30/2022 17:26,,Completed,,-20,874.9
QIU0XT9BIK,9/30/2022 13:54,,Completed,,-40,894.9
QIU2X9PB68,9/30/2022 9:44,,Completed,,-10,934.9
QIU0X80BDA,9/30/2022 9:20,,Completed,,-35,944.9
QIU8X6H8TA,9/30/2022 8:58,,Completed,,-45,979.9
QIT9WTNRYT,9/29/2022 22:24,,Completed,,-35,"1,024.90"
QIT6WPUPIQ,9/29/2022 21:18,,Completed,,-10,"1,059.90"
QIT1WP7M2X,9/29/2022 21:09,,Completed,,-5,"1,069.90"
QIT4WO3PG4,9/29/2022 20:56,,Completed,530,,"1,074.90"
QIT4WGPNGM,9/29/2022 19:43,,Completed,,-75,544.9
QIT8W98LDK,9/29/2022 18:45,,Completed,,-10,619.9
QIT2VXRARE,9/29/2022 16:56,,Completed,,-20,629.9
QIT0VG9SMY,9/29/2022 13:11,,Completed,,-50,649.9
QIT6V2E13A,9/29/2022 10:03,,Completed,,-10,699.9
QIT3UX7AYJ,9/29/2022 8:46,,Completed,,-40,709.9
QIS6SNFKRI,9/28/2022 8:20,,Completed,,-20,749.9
QIR1S8TJD9,9/27/2022 21:09,,Completed,,-120,769.9
QIR2RRTCXY,9/27/2022 18:37,,Completed,,-10,889.9
QIR4RCNCWS,9/27/2022 15:54,,Completed,,-5,899.9
Statement Verification Code,"To verify the validity of this M-PESA statement dial *334#, select My account and follow theprompts to enter the code.",,,,,
,,,,,,
LLHKTUZR,,,,,,
Receipt No.,Completion Time,,Transaction Status,Paid In,Withdrawn,Balance
QIR9R5KG6F,9/27/2022 14:22,,Completed,,-70,904.9
QIQ2PTL7K0,9/26/2022 20:02,,Completed,,-20,974.9
QIQ6PSIH8U,9/26/2022 19:52,,Completed,,-80,994.9
QIQ7PQGM6H,9/26/2022 19:35,,Completed,"1,000.00",,"1,074.90"
QIQ3PQDGGR,9/26/2022 19:34,,Completed,,-5,74.9
QIQ4PIYPNE,9/26/2022 18:38,,Completed,,-100,79.9
QIQ7PDOO3X,9/26/2022 17:50,,Completed,,-30,179.9
QIQ4OVCA34,9/26/2022 14:19,,Completed,,-50,209.9
QIQ4OID2VQ,9/26/2022 11:37,,Completed,,-20,259.9
QIQ4O37HNA,9/26/2022 8:03,,Completed,,-20,279.9
QIP0NSPLSU,9/25/2022 21:55,,Completed,20,,299.9
QIP6NSQA72,9/25/2022 21:52,,Completed,20,,279.9
QIP7NIC991,9/25/2022 19:32,,Completed,,-75,259.9
QIP7NHMTZL,9/25/2022 19:25,,Completed,,-70,334.9
QIP9N0LVDB,9/25/2022 16:25,,Completed,,-10,404.9
QIP7MV0F8B,9/25/2022 15:11,,Completed,,-20,414.9
QIP9MUVRA9,9/25/2022 15:09,,Completed,,-10,434.9
QIP4MQ327Y,9/25/2022 14:04,,Completed,,-70,444.9
QIP4M65UBK,9/25/2022 8:45,,Completed,,-20,514.9
QIO6LR0GYI,9/24/2022 21:11,,Completed,,-20,534.9
QIO5LQXGQD,9/24/2022 21:10,,Completed,170,,554.9
QIO4LQSLJY,9/24/2022 21:08,,Completed,,-5,384.9
QIO3LQFRP9,9/24/2022 21:03,,Completed,,-20,389.9
QIO6LPEGLO,9/24/2022 20:51,,Completed,,-10,409.9
QIO1LKEOXJ,9/24/2022 20:00,,Completed,,-80,419.9
QIO7L19R1D,9/24/2022 17:07,,Completed,,-20,499.9
QIO3JYD8VN,9/24/2022 8:42,,Completed,,-40,519.9
QIN7JMC595,9/23/2022 22:19,,Completed,,-10,559.9
QIN1JHBEYB,9/23/2022 21:01,,Completed,,-10,569.9
QIN1JEPVXJ,9/23/2022 20:32,,Completed,,-20,579.9
QIN6JDO2D0,9/23/2022 20:21,,Completed,,-10,599.9
QIN4J8XZU4,9/23/2022 19:38,,Completed,,-65,609.9
QIN6I9W61A,9/23/2022 13:29,,Completed,,-70,674.9
QIN4HY56OI,9/23/2022 10:54,,Completed,,-10,744.9
QIN9HP6IV7,9/23/2022 8:44,,Completed,,-45,754.9
QIM5HAWJRF,9/22/2022 21:16,,Completed,,-10,799.9
QIM1H0Z3H9,9/22/2022 19:32,,Completed,,-40,809.9
QIM4H0TCSS,9/22/2022 19:31,,Completed,,-20,849.9
QIM5H0OC1L,9/22/2022 19:29,,Completed,,-10,869.9
Statement Verification Code,"To verify the validity of this M-PESA statement dial *334#, select My account and follow theprompts to enter the code.",,,,,
,,,,,,
LLHKTUZR,,,,,,
Receipt No.,Completion Time,,Transaction Status,Paid In,Withdrawn,Balance
QIM2G07VAI,9/22/2022 12:37,,Completed,,-50,879.9
QIM8FR17PS,9/22/2022 10:31,,Completed,,-20,929.9
QIM5FMKAYT,9/22/2022 9:27,,Completed,58,,949.9
QIM3FMHWXT,9/22/2022 9:26,,Completed,,-20,891.9
QIL3F95KAJ,9/21/2022 22:23,,Completed,,-10,911.9
QIL9F7VCBD,9/21/2022 21:55,,Completed,,-10,921.9
QIL7F5Z46H,9/21/2022 21:24,,Completed,,-20,931.9
QIL3ETVOKF,9/21/2022 19:21,,Completed,,-65,951.9
QIL8ERPFDY,9/21/2022 19:04,,Completed,,-30,"1,016.90"
QIL0EO25LY,9/21/2022 18:34,,Completed,30,,"1,046.90"
QIL2EO1814,9/21/2022 18:34,,Completed,"1,000.00",,"1,016.90"
QIL4EE1YWO,9/21/2022 16:50,,Completed,,-20,16.9
QIL3E8MOE1,9/21/2022 15:40,,Completed,,-20,36.9
QIL4E464RY,9/21/2022 14:40,,Completed,,-70,56.9
QIL1DCYZWF,9/21/2022 8:29,,Completed,,-20,126.9
QIK9CPBHH7,9/20/2022 19:28,,Completed,,-65,146.9
QIK4BSH9P4,9/20/2022 13:14,,Completed,,-50,211.9
QIK0BKBUEO,9/20/2022 11:22,,Completed,,-5,261.9
QIJ1ANJY37,9/19/2022 19:45,,Completed,,-35,266.9
QIJ2A5DR3E,9/19/2022 16:55,,Completed,,-45,301.9
QII28TBLWG,9/18/2022 21:46,,Completed,,-10,346.9
QII38SE1O3,9/18/2022 21:30,,Completed,,-10,356.9
QIH46IVACC,9/17/2022 19:37,,Completed,,-50,366.9
QIH05PYHPO,9/17/2022 14:36,,Completed,,-70,416.9
QIH75264EV,9/17/2022 9:26,,Completed,,-50,486.9
QIH04ZTQOW,9/17/2022 8:50,,Completed,,-20,536.9
QIG64C5D3O,9/16/2022 19:50,,Completed,,-60,556.9
QIG941JGCH,9/16/2022 18:25,,Completed,600,,616.9
QIG041GFAY,9/16/2022 18:24,,Completed,,-5,16.9
QIG13HH7R5,9/16/2022 14:40,,Completed,,-50,21.9
QIF623B4MO,9/15/2022 19:42,,Completed,,-10,71.9
QIF62377UW,9/15/2022 19:42,,Completed,,-30,81.9
QIF716FMQR,9/15/2022 13:56,,Completed,,-65,111.9
QIF4104V8K,9/15/2022 12:33,,Completed,,-5,176.9
QIE0YYH7KI,9/14/2022 19:55,,Completed,,-70,181.9
QIE4YRFTO0,9/14/2022 18:59,,Completed,,-100,251.9
QIE5YIL9O9,9/14/2022 17:35,,Completed,,-50,351.9
QIE6YDM8I6,9/14/2022 16:34,,Completed,,-35,401.9
Statement Verification Code,"To verify the validity of this M-PESA statement dial *334#, select My account and follow theprompts to enter the code.",,,,,
,,,,,,
LLHKTUZR,,,,,,
Receipt No.,Completion Time,,Transaction Status,Paid In,Withdrawn,Balance
QIE9YBHL8X,9/14/2022 16:04,,Completed,,-70,436.9
QIE3XZUT7T,9/14/2022 13:30,,Completed,,-10,506.9
QID4WS5YWS,9/13/2022 19:22,,Completed,,-50,516.9
QID7W0Z7S5,9/13/2022 13:59,,Completed,,-50,566.9
QID0VXRBG2,9/13/2022 13:05,,Completed,,-20,616.9
QIC7UOVL51,9/12/2022 18:50,,Completed,,"-1,770.00",636.9
QIC1UOF8J5,9/12/2022 18:46,,Completed,"2,400.00",,"2,406.90"
QIC9UO4QHD,9/12/2022 18:44,,Completed,,-10,6.9
QIC1U3HDB7,9/12/2022 14:50,,Completed,,-50,16.9
QIC7TCKZ8N,9/12/2022 8:36,,Completed,,-20,66.9
QIB1SRGTLZ,9/11/2022 19:45,,Completed,,-60,86.9
QIB8RVOFEM,9/11/2022 13:33,,Completed,,-100,146.9
QIA6Q5HWRE,9/10/2022 16:25,,Completed,,-530,246.9
QIA0Q2QM22,9/10/2022 15:52,,Completed,700,,776.9
QIA8PYZSI8,9/10/2022 15:06,,Completed,,"-1,650.00",76.9
QIA6PLYK3I,9/10/2022 12:20,,Completed,,"-5,000.00","1,726.90"
QIA2PLWOZ0,9/10/2022 12:19,,Completed,"6,500.00",,"6,726.90"
QIA4PLUE68,9/10/2022 12:19,,Completed,,-10,226.9
QI92OX0D5W,9/9/2022 22:47,,Completed,,-99,236.9
QI94OWYTR8,9/9/2022 22:46,,Completed,,"-1,000.00",335.9
QI98OWX2MU,9/9/2022 22:44,,Completed,"1,300.00",,"1,335.90"
QI95NBDJH7,9/9/2022 11:20,,Completed,,-10,35.9
QI91NBAW87,9/9/2022 11:19,,Completed,,-30,45.9
QI83M2VDQJ,9/8/2022 18:15,,Completed,,-30,75.9
QI87M2RHVD,9/8/2022 18:14,,Completed,100,,105.9
QI78K2BHJY,9/7/2022 18:40,,Completed,,-10,5.9
QI65H4CZ43,9/6/2022 12:48,,Completed,,-10,15.9
QI52FMZPR8,9/5/2022 17:36,,Completed,,-50,25.9
QI52FMZPR8,9/5/2022 17:36,,Completed,,"-2,600.00",75.9
QI52FMT56K,9/5/2022 17:34,,Completed,,-300,"2,675.90"
QI56FM8L28,9/5/2022 17:28,,Completed,,-30,"2,975.90"
QI59FKFZ8L,9/5/2022 17:09,,Completed,,-280,"3,005.90"
QI55FGO6E5,9/5/2022 16:21,,Completed,"3,100.00",,"3,285.90"
QI49DB94HZ,9/4/2022 15:28,,Completed,,-85,185.9
QI41D7B5ZF,9/4/2022 14:36,,Completed,,-30,270.9
QI249O86F2,9/2/2022 19:15,,Completed,300,,300.9
QI209O4PXA,9/2/2022 19:14,,Completed,,-6,0.9
QI208O35TG,9/2/2022 12:21,,Completed,,-5,6.9
QI166PQ3L0,9/1/2022 13:50,,Completed,,-50,11.9
Statement Verification Code,"To verify the validity of this M-PESA statement dial *334#, select My account and follow theprompts to enter the code.",,,,,
,,,,,,
LLHKTUZR,,,,,,
Receipt No.,Completion Time,,Transaction Status,Paid In,Withdrawn,Balance
QI186KOLXE,9/1/2022 12:42,,Completed,,-10,61.9
QHV244QE5O,8/31/2022 9:58,,Completed,,-27,71.9
QHV244QE5O,8/31/2022 9:58,,Completed,,-150,98.9
QHU52O2W2N,8/30/2022 14:53,,Completed,,-10,248.9
QHU52O2W2N,8/30/2022 14:53,,Completed,,-50,258.9
QHU22ASMXW,8/30/2022 11:38,,Completed,,-23,308.9
QHU22ASMXW,8/30/2022 11:38,,Completed,,-450,331.9
QHU622MJ7E,8/30/2022 9:31,,Completed,,-20,781.9
QHU922L0XB,8/30/2022 9:30,,Completed,800,,801.9
QHU322CO9J,8/30/2022 9:27,,Completed,,-5,1.9
QHT61LMFTS,8/29/2022 21:05,,Completed,,-51,6.9
QHT61LMFTS,8/29/2022 21:05,,Completed,,"-3,320.00",57.9
QHT81LG8TS,8/29/2022 21:02,,Completed,"1,080.00",,"3,377.90"
QHT81LD9HW,8/29/2022 21:01,,Completed,"1,080.00",,"2,297.90"
QHT11JUCX1,8/29/2022 20:41,,Completed,580,,"1,217.90"
QHT81JQ1O2,8/29/2022 20:40,,Completed,580,,637.9
QHT6ZQT4ZC,8/29/2022 15:31,,Completed,,-10,57.9
QHT0ZK1Y9G,8/29/2022 13:56,,Completed,,-40,67.9
QHT6YYYPSG,8/29/2022 8:39,,Completed,,"-2,999.00",107.9
QHS5XNCPMP,8/28/2022 14:00,,Completed,,-407,"3,106.90"
QHS2XNAC6S,8/28/2022 13:59,,Completed,"3,500.00",,"3,513.90"
QHS6XA99L4,8/28/2022 10:19,,Completed,,-28,13.9
QHS6XA99L4,8/28/2022 10:19,,Completed,,-700,41.9
QHS8XA8L7Y,8/28/2022 10:19,,Completed,700,,741.9
QHS3XA7625,8/28/2022 10:18,,Completed,,-10,41.9
QHR1WT74D1,8/27/2022 21:42,,Completed,,-50,51.9
QHR2VNV034,8/27/2022 13:44,,Completed,,-100,101.9
QHR3VGF1EV,8/27/2022 12:02,,Completed,,-30,201.9
QHR8VG1MSU,8/27/2022 11:57,,Completed,,-2,231.9
QHR8VG1MSU,8/27/2022 11:57,,Completed,,-100,233.9
QHR6VFX4YO,8/27/2022 11:55,,Completed,300,,333.9
QHR9V7XG9D,8/27/2022 9:55,,Completed,,-10,33.9
QHQ0UB4SOI,8/26/2022 18:45,,Completed,,-50,43.9
QHQ6U30VMU,8/26/2022 17:24,,Completed,,-10,93.9
QHQ6U30VMU,8/26/2022 17:24,,Completed,,-100,103.9
QHQ4TNKB8I,8/26/2022 14:01,,Completed,,-20,203.9
QHQ6TMV662,8/26/2022 13:51,,Completed,,-23,223.9
QHQ6TMV662,8/26/2022 13:51,,Completed,,-450,246.9
QHQ5TMJ2XZ,8/26/2022 13:46,,Completed,,-55,696.9
QHQ4TLEAM8,8/26/2022 13:31,,Completed,,-30,751.9
Statement Verification Code,"To verify the validity of this M-PESA statement dial *334#, select My account and follow theprompts to enter the code.",,,,,
,,,,,,
LLHKTUZR,,,,,,
Receipt No.,Completion Time,,Transaction Status,Paid In,Withdrawn,Balance
QHQ8TKYQ40,8/26/2022 13:24,,Completed,,-35,781.9
QHO5QEMWJH,8/24/2022 18:56,,Completed,,-10,"8,116.90"
QHO7QEIAIB,8/24/2022 18:55,,Completed,,-30,"8,126.90"
QHO8QAT9G8,8/24/2022 18:19,,Completed,,"-2,500.00","8,156.90"
QHM3LXEW7L,8/22/2022 13:34,,Completed,,-30,"14,781.90"
QHL5K5QYV9,8/21/2022 14:18,,Completed,,-70,"14,901.90"
QHJ9GP8073,8/19/2022 17:16,,Completed,,-32,"20,383.90"
QHJ9GP8073,8/19/2022 17:16,,Completed,,"-2,000.00","20,415.90"
QHJ8GP3IV0,8/19/2022 17:14,,Completed,400,,"22,415.90"
QHJ9GOYFTL,8/19/2022 17:12,,Completed,"22,000.00",,"22,015.90"
QHJ0GMORVA,8/19/2022 16:44,,Completed,,-195,15.9
QHJ8GMNR1E,8/19/2022 16:43,,Completed,200,,210.9
QHJ4G48WW2,8/19/2022 12:16,,Completed,,"-4,000.00",10.9
QHH7D3RDI3,8/17/2022 18:56,,Completed,,-10,570.9
QHG3B15GDH,8/16/2022 17:33,,Completed,,-30,580.9
QHG1APWRTD,8/16/2022 14:48,,Completed,,-5,610.9
QHG9AIB3EX,8/16/2022 12:53,,Completed,,-10,615.9
QHG8ACWVL2,8/16/2022 11:29,,Completed,,-30,625.9
QHF19C8U2P,8/15/2022 17:33,,Completed,,-50,655.9
QHF3911MYL,8/15/2022 14:34,,Completed,200,,705.9
QHF490YCE0,8/15/2022 14:32,,Completed,,-12,505.9
QHF490YCE0,8/15/2022 14:32,,Completed,,-700,517.9
QHF7909FYF,8/15/2022 14:22,,Completed,,-30,"1,217.90"
QHE27BOWSU,8/14/2022 15:13,,Completed,,-10,"1,247.90"
QHE877VK7G,8/14/2022 14:15,,Completed,500,,"1,257.90"
QHE46V8V0I,8/14/2022 10:29,,Completed,,-50,757.9
QHD75KXJ3R,8/13/2022 15:35,,Completed,,-2,807.9
QHD75KXJ3R,8/13/2022 15:35,,Completed,,-100,809.9
QHD15J9T8L,8/13/2022 15:12,,Completed,200,,909.9
QHD64ZVZMY,8/13/2022 10:26,,Completed,,-6,709.9
QHD64ZVZMY,8/13/2022 10:26,,Completed,,-200,715.9
QHD94ZRAG7,8/13/2022 10:24,,Completed,,-10,915.9
QHC33PBKBX,8/12/2022 15:25,,Completed,,-100,925.9
QHC93P67O9,8/12/2022 15:23,,Completed,850,,"1,025.90"
QHB12O4G4B,8/11/2022 20:58,,Completed,,-10,175.9
QHB5272333,8/11/2022 17:39,,Completed,,-6,185.9
QHB5272333,8/11/2022 17:39,,Completed,,-190,191.9
QHB0270ZPQ,8/11/2022 17:39,,Completed,200,,381.9
QHA2ZPHKEG,8/10/2022 19:20,,Completed,,-10,181.9
QHA4Z5EOW4,8/10/2022 14:45,,Completed,,-112,191.9
QHA4Z5EOW4,8/10/2022 14:45,,Completed,,"-30,000.00",303.9
QHA1Z4EEFJ,8/10/2022 14:29,,Completed,"20,000.00",,"30,303.90"
QHA1YTV3HH,8/10/2022 11:38,,Completed,,-12,"10,303.90"
Statement Verification Code,"To verify the validity of this M-PESA statement dial *334#, select My account and follow theprompts to enter the code.",,,,,
,,,,,,
LLHKTUZR,,,,,,
Receipt No.,Completion Time,,Transaction Status,Paid In,Withdrawn,Balance
QHA1YTV3HH,8/10/2022 11:38,,Completed,,-750,"10,315.90"
QHA6YHUY1K,8/10/2022 7:41,,Completed,,-23,"11,065.90"
QHA6YHUY1K,8/10/2022 7:41,,Completed,,-200,"11,088.90"
QHA1YHT0E7,8/10/2022 7:39,,Completed,,-23,"11,288.90"
QHA1YHT0E7,8/10/2022 7:39,,Completed,,-200,"11,311.90"
QH96XZ4Q6W,8/9/2022 18:57,,Completed,,-100,"11,511.90"
QH99XJ907L,8/9/2022 14:56,,Completed,,-75,"11,611.90"
QH99XJ907L,8/9/2022 14:56,,Completed,,"-7,100.00","11,686.90"
QH91XF1TRV,8/9/2022 13:42,,Completed,,-5,"18,786.90"
QH92XCFRAK,8/9/2022 12:55,,Completed,,-10,"18,791.90"
QH84W7MZDK,8/8/2022 18:49,,Completed,,-27,"18,801.90"
QH84W7MZDK,8/8/2022 18:49,,Completed,,-330,"18,828.90"
QH80W64YMM,8/8/2022 18:35,,Completed,,-5,"19,158.90"
QH89W2MQC5,8/8/2022 17:59,,Completed,,-10,"19,163.90"
QH82VTH802,8/8/2022 16:14,,Completed,,-23,"19,173.90"
QH82VTH802,8/8/2022 16:14,,Completed,,-270,"19,196.90"
QH83VRDHM3,8/8/2022 15:47,,Completed,,"-1,000.00","19,466.90"
QH81VRCQXR,8/8/2022 15:47,,Completed,"2,000.00",,"20,466.90"
QH86VPX192,8/8/2022 15:29,,Completed,,-12,"18,466.90"
QH86VPX192,8/8/2022 15:29,,Completed,,"-1,000.00","18,478.90"
QH85VOBMB1,8/8/2022 15:08,,Completed,20,,"19,478.90"
QH81VO9QF1,8/8/2022 15:07,,Completed,100,,"19,458.90"
QH85VO95L5,8/8/2022 15:07,,Completed,,"-1,050.00","19,358.90"
QH81VD8KDL,8/8/2022 12:43,,Completed,,-27,"20,408.90"
QH81VD8KDL,8/8/2022 12:43,,Completed,,-200,"20,435.90"
QH82UP8B6W,8/8/2022 0:05,,Completed,,-5,"20,635.90"
QH74U81CJY,8/7/2022 19:10,,Completed,,-100,"20,640.90"
QH77TC5C81,8/7/2022 12:03,,Completed,,-10,"20,740.90"
QH63S819BL,8/6/2022 18:58,,Completed,,-5,"20,750.90"
QH50P7PEFY,8/5/2022 13:23,,Completed,,-5,"20,755.90"
QH40O0C770,8/4/2022 19:48,,Completed,,-30,"20,760.90"
QH40MPL1VK,8/4/2022 10:37,,Completed,,"-2,000.00","20,790.90"
QH36LCPPUS,8/3/2022 16:44,,Completed,,-51,"22,790.90"
QH36LCPPUS,8/3/2022 16:44,,Completed,,"-2,700.00","22,841.90"
QH35L74VWZ,8/3/2022 15:34,,Completed,,-6,"25,541.90"
QH35L74VWZ,8/3/2022 15:34,,Completed,,-500,"25,547.90"
QH37KUA34Z,8/3/2022 12:48,,Completed,,-75,"26,047.90"
QH37KUA34Z,8/3/2022 12:48,,Completed,,"-6,500.00","26,122.90"
QH36KRSODE,8/3/2022 12:15,,Completed,"32,000.00",,"32,622.90"
QH39KQ6Z39,8/3/2022 11:53,,Completed,,-2,622.9
QH39KQ6Z39,8/3/2022 11:53,,Completed,,-100,624.9
QH39KPYZPF,8/3/2022 11:50,,Completed,,-10,724.9
QH39KBW72R,8/3/2022 8:24,,Completed,,-5,734.9
QH29K2TOHR,8/2/2022 22:22,,Completed,,-600,739.9
Statement Verification Code,"To verify the validity of this M-PESA statement dial *334#, select My account and follow theprompts to enter the code.",,,,,
,,,,,,
LLHKTUZR,,,,,,
Receipt No.,Completion Time,,Transaction Status,Paid In,Withdrawn,Balance
QH25JZ3WPV,8/2/2022 21:15,,Completed,,-12,"1,339.90"
QH25JZ3WPV,8/2/2022 21:15,,Completed,,"-1,000.00","1,351.90"
QH21JVR76L,8/2/2022 20:33,,Completed,,-22,"2,351.90"
QH21JVR76L,8/2/2022 20:33,,Completed,,"-1,200.00","2,373.90"
QH28I5469G,8/2/2022 7:19,,Completed,,-10,"3,573.90"
QH21I3UO4R,8/2/2022 6:39,,Completed,,-2,"3,583.90"
QH21I3UO4R,8/2/2022 6:39,,Completed,,-100,"3,585.90"
QH11HSZ90H,8/1/2022 20:51,,Completed,,-2,"3,685.90"
QH11HSZ90H,8/1/2022 20:51,,Completed,,-100,"3,687.90"
QH12HJXWT2,8/1/2022 19:25,,Completed,,-100,"3,787.90"
QH16HHPDD6,8/1/2022 19:07,,Completed,,-10,"3,887.90"
QH15GMTLT3,8/1/2022 13:13,,Completed,,-1,"3,897.90"
QH15GMTLT3,8/1/2022 13:13,,Completed,,-20,"3,898.90"
QH16GHDUKA,8/1/2022 11:57,,Completed,,-34,"3,918.90"
QH16GHDUKA,8/1/2022 11:57,,Completed,,"-1,000.00","3,952.90"
QH13GGECJV,8/1/2022 11:43,,Completed,,"-2,999.00","4,952.90"
QH11GGCL7T,8/1/2022 11:42,,Completed,"3,000.00",,"7,951.90"
QH19G9H3NL,8/1/2022 10:02,,Completed,,-50,"4,951.90"
QH17G8RCL3,8/1/2022 9:51,,Completed,,-20,"5,001.90"
QH18G43UOQ,8/1/2022 8:37,,Completed,,-10,"5,021.90"
QH11G38VXZ,8/1/2022 8:22,,Completed,,-2,"5,031.90"
QH11G38VXZ,8/1/2022 8:22,,Completed,,-100,"5,033.90"
QH17G0A16J,8/1/2022 7:19,,Completed,,-5,"5,133.90"
QGV0FF6DP6,7/31/2022 19:21,,Completed,"5,100.00",,"5,138.90"
QGV3F7UJ3T,7/31/2022 18:06,,Completed,,-6,38.9
QGV3F7UJ3T,7/31/2022 18:06,,Completed,,-200,44.9
QGV5E5DHV5,7/31/2022 8:18,,Completed,,-15,244.9
QGU9CRVY8H,7/30/2022 14:41,,Completed,,-10,259.9
QGT7B1SQDD,7/29/2022 17:47,,Completed,,-30,269.9
QGT3AS7DAF,7/29/2022 15:53,,Completed,,-28,299.9
QGT3AS7DAF,7/29/2022 15:53,,Completed,,"-1,000.00",327.9
QGT3AEHY1H,7/29/2022 12:45,,Completed,,-23,"1,327.90"
QGT3AEHY1H,7/29/2022 12:45,,Completed,,-150,"1,350.90"
QGT2AE9T0U,7/29/2022 12:42,,Completed,"1,500.00",,"1,500.90"
QGT2AC4BDW,7/29/2022 12:11,,Completed,,-5,0.9
QGS88Y8YUY,7/28/2022 17:33,,Completed,,-205,5.9
QGS18UQ2AP,7/28/2022 16:51,,Completed,80,,210.9
QGS88UO218,7/28/2022 16:51,,Completed,,-5,130.9
QGS48DMO4S,7/28/2022 12:52,,Completed,,-10,135.9
QGS58BLOFL,7/28/2022 12:22,,Completed,,-28,145.9
QGS58BLOFL,7/28/2022 12:22,,Completed,,-600,173.9
QGS3809EAH,7/28/2022 9:29,,Completed,,-20,773.9
QGR17EG5KJ,7/27/2022 20:10,,Completed,,-50,793.9
Statement Verification Code,"To verify the validity of this M-PESA statement dial *334#, select My account and follow theprompts to enter the code.",,,,,
,,,,,,
LLHKTUZR,,,,,,
Receipt No.,Completion Time,,Transaction Status,Paid In,Withdrawn,Balance
QGR86IM9Z8,7/27/2022 14:07,,Completed,,-60,843.9
QGR86DA3AG,7/27/2022 12:51,,Completed,800,,903.9
QGR661H9G2,7/27/2022 9:50,,Completed,,-20,103.9
QGQ15BHKRL,7/26/2022 19:34,,Completed,,-65,123.9
QGQ04ZMLJY,7/26/2022 17:40,,Completed,,-30,188.9
QGQ14YXC1R,7/26/2022 17:32,,Completed,10,,218.9
QGQ14YQRB9,7/26/2022 17:30,,Completed,20,,208.9
QGQ64KV7O0,7/26/2022 14:19,,Completed,,-50,188.9
QGQ04KSVSO,7/26/2022 14:17,,Completed,200,,238.9
QGQ04JXG62,7/26/2022 14:05,,Completed,,-5,38.9
QGQ94H1ZI9,7/26/2022 13:24,,Completed,,-10,43.9
QGQ341BIGD,7/26/2022 9:23,,Completed,,-40,53.9
QGP93HDJZ7,7/25/2022 20:16,,Completed,,-25,93.9
QGP039HF6A,7/25/2022 19:04,,Completed,,-10,118.9
QGP433XI5W,7/25/2022 18:10,,Completed,,-20,128.9
QGP120ETI3,7/25/2022 8:37,,Completed,,-40,148.9
QGO61LVV7A,7/24/2022 20:47,,Completed,,-5,188.9
QGO71GJ4TD,7/24/2022 19:47,,Completed,,-40,193.9
QGO51DOET9,7/24/2022 19:20,,Completed,,-20,233.9
QGO71634BH,7/24/2022 17:56,,Completed,,-25,253.9
QGO7ZOED1F,7/24/2022 13:35,,Completed,,-60,278.9
QGO6ZOA9RQ,7/24/2022 13:33,,Completed,300,,338.9
QGO5ZO8EWH,7/24/2022 13:33,,Completed,,-5,38.9
QGO1Z9RSON,7/24/2022 9:08,,Completed,,-10,43.9
QGO7Z7E26D,7/24/2022 8:18,,Completed,,-20,53.9
QGN4Z00OW8,7/23/2022 22:39,,Completed,,-5,73.9
QGN1YS1WUB,7/23/2022 20:32,,Completed,,-2,78.9
QGN1YS1WUB,7/23/2022 20:32,,Completed,,-100,80.9
QGN5YOF7OV,7/23/2022 19:55,,Completed,,-65,180.9
QGN7Y8744P,7/23/2022 17:13,,Completed,,-10,245.9
QGN8XULSQU,7/23/2022 14:06,,Completed,,-50,255.9
QGN6XD5O2E,7/23/2022 9:46,,Completed,,-20,305.9
QGM5WQ0XT5,7/22/2022 20:06,,Completed,,-40,325.9
QGM3VXENZ7,7/22/2022 14:39,,Completed,,-60,365.9
QGM3VA7AZF,7/22/2022 8:41,,Completed,,-30,425.9
QGL9UVU193,7/21/2022 20:54,,Completed,,-30,455.9
Statement Verification Code,"To verify the validity of this M-PESA statement dial *334#, select My account and follow theprompts to enter the code.",,,,,
,,,,,,
LLHKTUZR,,,,,,
Receipt No.,Completion Time,,Transaction Status,Paid In,Withdrawn,Balance
QGL9UPWMGT,7/21/2022 19:49,,Completed,,-90,485.9
QGL7TV3ZNL,7/21/2022 13:30,,Completed,,-60,575.9
QGL6TB061Y,7/21/2022 7:57,,Completed,,-20,635.9
QGK5SPP91H,7/20/2022 19:25,,Completed,,-65,655.9
QGK3S0SHWX,7/20/2022 14:22,,Completed,,-35,720.9
QGK0RXZJMO,7/20/2022 13:41,,Completed,,-40,755.9
QGK1RU7E1H,7/20/2022 12:45,,Completed,,-10,795.9
QGJ1R14PQD,7/19/2022 20:52,,Completed,,-60,805.9
QGJ8QLOF3E,7/19/2022 18:16,,Completed,,-10,865.9
QGJ1QIU62T,7/19/2022 17:46,,Completed,500,,875.9
QGJ4PHAX0Y,7/19/2022 8:32,,Completed,,-20,375.9
QGI1OVMWED,7/18/2022 19:30,,Completed,,-75,395.9
QGI5O4GZZB,7/18/2022 14:08,,Completed,,-60,470.9
QGI3O0LYF9,7/18/2022 13:15,,Completed,500,,530.9
QGI6O0J224,7/18/2022 13:14,,Completed,,-6,30.9
QGI7NOVP0J,7/18/2022 10:20,,Completed,,-10,36.9
QGI2NIIW6A,7/18/2022 8:38,,Completed,,-20,46.9
QGH6MSK56K,7/17/2022 18:53,,Completed,,-50,66.9
QGH6M9OAFQ,7/17/2022 14:43,,Completed,,-10,116.9
QGH6M51GNE,7/17/2022 13:33,,Completed,,-50,126.9
QGG9L212SP,7/16/2022 19:32,,Completed,,-80,176.9
QGG7JMRF3B,7/16/2022 8:13,,Completed,,-10,256.9
QGF8J0U2PW,7/15/2022 19:34,,Completed,,-65,266.9
QGF0IPMXEI,7/15/2022 17:51,,Completed,5,,331.9
QGF6IPMFZQ,7/15/2022 17:51,,Completed,,-10,326.9
QGF5I6XUPX,7/15/2022 13:52,,Completed,,-50,336.9
QGF8I6FHXO,7/15/2022 13:45,,Completed,,-10,386.9
QGF2HV84SO,7/15/2022 11:04,,Completed,,-10,396.9
QGF2HV84SO,7/15/2022 11:04,,Completed,,-100,406.9
QGF1HS60M3,7/15/2022 10:18,,Completed,,-20,506.9
QGE8GZ1A56,7/14/2022 19:31,,Completed,,-60,526.9
QGE5G1NOZL,7/14/2022 12:39,,Completed,,-50,586.9
QGE0FKVBBC,7/14/2022 8:13,,Completed,,-40,636.9
QGD0FCMUHO,7/13/2022 22:16,,Completed,,-35,676.9
QGD3FACTST,7/13/2022 21:33,,Completed,,-40,711.9
QGD4EWLQY2,7/13/2022 19:09,,Completed,,-5,751.9
Statement Verification Code,"To verify the validity of this M-PESA statement dial *334#, select My account and follow theprompts to enter the code.",,,,,
,,,,,,
LLHKTUZR,,,,,,
Receipt No.,Completion Time,,Transaction Status,Paid In,Withdrawn,Balance
QGD6E3HF34,7/13/2022 13:10,,Completed,,-45,756.9
QGC0CY5OE6,7/12/2022 19:31,,Completed,,-20,801.9
QGC7CX3879,7/12/2022 19:22,,Completed,,-60,821.9
QGC5BRCDVB,7/12/2022 10:51,,Completed,,-35,881.9
QGC4BLAGXI,7/12/2022 9:23,,Completed,,-30,916.9
QGC5BCOIPZ,7/12/2022 5:10,,Completed,,-10,946.9
QGB7B00MHH,7/11/2022 20:16,,Completed,,-10,956.9
QGB2AUVEMK,7/11/2022 19:29,,Completed,,-65,966.9
QGB9AURJFX,7/11/2022 19:28,,Completed,"1,000.00",,"1,031.90"
QGB4AUP8TM,7/11/2022 19:27,,Completed,,-5,31.9
QGB5AI2BR7,7/11/2022 17:21,,Completed,,-6,36.9
QGB5AI2BR7,7/11/2022 17:21,,Completed,,-500,42.9
QGB0AF7HAG,7/11/2022 16:47,,Completed,,-100,542.9
QGB09WO8ZC,7/11/2022 12:44,,Completed,,-10,642.9
QGB69MVODW,7/11/2022 10:27,,Completed,,-90,652.9
QGA68VF8MC,7/10/2022 19:40,,Completed,,-80,742.9
QGA88477S4,7/10/2022 14:01,,Completed,,-60,822.9
QG966XD4FA,7/9/2022 19:29,,Completed,,-70,882.9
QG975DZLPN,7/9/2022 7:21,,Completed,,-30,952.9
QG87504KYT,7/8/2022 20:40,,Completed,,-25,982.9
QG864ZYVTI,7/8/2022 20:38,,Completed,,-10,"1,007.90"
QG864ZYVTI,7/8/2022 20:38,,Completed,,-100,"1,017.90"
QG834ZUIKL,7/8/2022 20:36,,Completed,"1,100.00",,"1,117.90"
QG864ZR59G,7/8/2022 20:35,,Completed,,"-1,785.00",17.9
QG814NFNHJ,7/8/2022 18:43,,Completed,,-40,"1,802.90"
QG814H6X6Z,7/8/2022 17:42,,Completed,,-10,"1,842.90"
QG814H6X6Z,7/8/2022 17:42,,Completed,,-50,"1,852.90"
QG874BWHWL,7/8/2022 16:45,,Completed,,-50,"1,902.90"
QG8941QKC1,7/8/2022 14:38,,Completed,,-30,"1,952.90"
QG863G7KJG,7/8/2022 9:51,,Completed,,-95,"1,982.90"
QG893F9SRR,7/8/2022 9:37,,Completed,,-20,"2,077.90"
QG782TMFDW,7/7/2022 20:22,,Completed,,-100,"2,097.90"
QG732O7MFD,7/7/2022 19:32,,Completed,,-80,"2,197.90"
QG7526TPLH,7/7/2022 16:41,,Completed,,-10,"2,277.90"
QG771Z1451,7/7/2022 15:00,,Completed,,-60,"2,287.90"
QG7219PSF4,7/7/2022 9:18,,Completed,,-30,"2,347.90"
QG7819KC38,7/7/2022 9:16,,Completed,,-20,"2,377.90"
Statement Verification Code,"To verify the validity of this M-PESA statement dial *334#, select My account and follow theprompts to enter the code.",,,,,
,,,,,,
LLHKTUZR,,,,,,
Receipt No.,Completion Time,,Transaction Status,Paid In,Withdrawn,Balance
QG67ZI310P,7/6/2022 19:29,,Completed,"2,100.00",,"2,397.90"
QG63ZHBNUR,7/6/2022 19:23,,Completed,,-75,297.9
QG66Z1YE2K,7/6/2022 16:52,,Completed,,-5,372.9
QG63YTHCM9,7/6/2022 15:04,,Completed,,-45,377.9
QG61Y05S63,7/6/2022 8:19,,Completed,,-40,422.9
QG51XC8DB9,7/5/2022 19:29,,Completed,,-65,462.9
QG53XC5FGH,7/5/2022 19:28,,Completed,500,,527.9
QG57XC19LV,7/5/2022 19:27,,Completed,,-5,27.9
QG56WYCF30,7/5/2022 17:17,,Completed,,-20,32.9
QG56WN6I6Q,7/5/2022 14:56,,Completed,,-30,52.9
QG54WM4R1I,7/5/2022 14:42,,Completed,,-50,82.9
QG58W4MYM4,7/5/2022 10:47,,Completed,,-10,132.9
QG58W4MYM4,7/5/2022 10:47,,Completed,,-100,142.9
QG58VY0MKG,7/5/2022 9:11,,Completed,,-20,242.9
QG46VAK3RA,7/4/2022 19:53,,Completed,,-100,262.9
QG47V8I401,7/4/2022 19:36,,Completed,,-50,362.9
QG43URMLBR,7/4/2022 16:49,,Completed,,-30,412.9
QG43UE07HP,7/4/2022 13:50,,Completed,,-60,442.9
QG42UDW7PU,7/4/2022 13:48,,Completed,500,,502.9
QG49UDUDB7,7/4/2022 13:48,,Completed,,-5,2.9
QG49UDLYPB,7/4/2022 13:45,,Completed,5,,7.9
QG41U1TOH5,7/4/2022 11:07,,Completed,,-40,2.9
QG48U1ODZK,7/4/2022 11:05,,Completed,,-5,42.9
QG48TRUMNW,7/4/2022 8:39,,Completed,,-20,47.9
QG33T52IPJ,7/3/2022 19:25,,Completed,,-80,67.9
QG39T03011,7/3/2022 18:35,,Completed,,-15,147.9
QG39SYRLJZ,7/3/2022 18:20,,Completed,,-50,162.9
QG37SGJ30L,7/3/2022 14:15,,Completed,,-60,212.9
QG37S0RMAF,7/3/2022 10:00,,Completed,,-20,272.9
QG24R77D5K,7/2/2022 19:27,,Completed,,-70,292.9
QG15PBWUON,7/1/2022 21:04,,Completed,"5,500.00",,"5,552.90"
QG14OG4ZOG,7/1/2022 15:42,,Completed,,-50,137.9
QG17OD5GZ9,7/1/2022 15:05,,Completed,,-50,187.9
QG16O5JM6U,7/1/2022 13:28,,Completed,,-60,237.9
QG14O12RT6,7/1/2022 12:30,,Completed,,-100,297.9
QG17O0VGVF,7/1/2022 12:27,,Completed,,-5,397.9
Statement Verification Code,"To verify the validity of this M-PESA statement dial *334#, select My account and follow theprompts to enter the code.",,,,,
,,,,,,
LLHKTUZR,,,,,,
Receipt No.,Completion Time,,Transaction Status,Paid In,Withdrawn,Balance
QG10NLGVJK,7/1/2022 8:53,,Completed,,-30,402.9
QG12NKWYUI,7/1/2022 8:44,,Completed,,-40,432.9
QG16NJBG8Y,7/1/2022 8:18,,Completed,,-50,472.9
QG17NJ1M2P,7/1/2022 8:13,,Completed,,-799,522.9
QG12NIZN44,7/1/2022 8:12,,Completed,"1,000.00",,"1,321.90"
QFU8MWAO0A,6/30/2022 19:43,,Completed,,-90,321.9
QFU5MW6OZB,6/30/2022 19:42,,Completed,400,,411.9
QFU4M0DOLO,6/30/2022 13:48,,Completed,,-60,11.9
QFU0LTL0H2,6/30/2022 12:16,,Completed,,-5,71.9
QFU1LJZ5VP,6/30/2022 9:55,,Completed,,-20,76.9
QFU3LI76OR,6/30/2022 9:28,,Completed,,-35,96.9
QFU9LCWR1L,6/30/2022 7:59,,Completed,,-20,131.9
QFT7KU15T7,6/29/2022 19:46,,Completed,,-50,151.9
QFT7KFWQR7,6/29/2022 17:34,,Completed,,-5,201.9
QFT8K5F6MU,6/29/2022 15:18,,Completed,,-5,206.9
QFT8JTLNDS,6/29/2022 12:34,,Completed,,-10,211.9
QFT8JTLNDS,6/29/2022 12:34,,Completed,,-100,221.9
QFT3JTCITV,6/29/2022 12:30,,Completed,,-6,321.9
QFT3JTCITV,6/29/2022 12:30,,Completed,,-120,327.9
QFT9JNRHSF,6/29/2022 11:09,,Completed,500,,607.9
QFT6JNPVD0,6/29/2022 11:08,,Completed,,-5,107.9
QFS3HDQ363,6/28/2022 8:39,,Completed,,-20,372.9
QFS4H8M4KI,6/28/2022 6:28,,Completed,,-35,392.9
QFR4GSWQMK,6/27/2022 19:41,,Completed,,-90,427.9
QFR7G0JJ7V,6/27/2022 14:13,,Completed,,-60,517.9
QFR5FF56TZ,6/27/2022 8:53,,Completed,,-35,577.9
QFR6FCE19U,6/27/2022 8:02,,Completed,,-20,612.9
QFQ7EXC2CJ,6/26/2022 20:05,,Completed,,-40,632.9
QFQ5EVKT33,6/26/2022 19:46,,Completed,,-30,672.9
QFQ1EIC92B,6/26/2022 17:20,,Completed,,-10,702.9
QFQ7EHZYLL,6/26/2022 17:16,,Completed,,-45,712.9
QFQ6EHLQ6M,6/26/2022 17:10,,Completed,,-5,757.9
QFQ5EB93OJ,6/26/2022 15:39,,Completed,,-10,762.9
QFQ0E72HEQ,6/26/2022 14:36,,Completed,,-50,772.9
QFQ4DOCMM6,6/26/2022 9:05,,Completed,,-50,822.9
QFP7C982RT,6/25/2022 13:59,,Completed,,-60,872.9
QFO8BDK80G,6/24/2022 21:49,,Completed,,-2,932.9
Statement Verification Code,"To verify the validity of this M-PESA statement dial *334#, select My account and follow theprompts to enter the code.",,,,,
,,,,,,
LLHKTUZR,,,,,,
Receipt No.,Completion Time,,Transaction Status,Paid In,Withdrawn,Balance
QFO8BDK80G,6/24/2022 21:49,,Completed,,-100,934.9
QFO3B2ACEJ,6/24/2022 19:33,,Completed,,-65,"1,034.90"
QFO8A853CK,6/24/2022 13:41,,Completed,,-50,"1,099.90"
QFO29T4WO4,6/24/2022 9:57,,Completed,,-30,"1,149.90"
QFN598TQ03,6/23/2022 20:30,,Completed,,-97,"1,179.90"
QFN598TQ03,6/23/2022 20:30,,Completed,,"-13,500.00","1,276.90"
QFN598R1T1,6/23/2022 20:30,,Completed,"12,800.00",,"14,776.90"
QFN894K7QC,6/23/2022 19:45,,Completed,,-100,"1,976.90"
QFN193ZZYF,6/23/2022 19:40,,Completed,,-80,"2,076.90"
QFN98QX2E1,6/23/2022 17:32,,Completed,"1,300.00",,"2,156.90"
QFN37Y3YYV,6/23/2022 10:35,,Completed,,-5,856.9
QFM37789YX,6/22/2022 19:48,,Completed,,-5,861.9
QFM975O3WD,6/22/2022 19:34,,Completed,,-35,866.9
QFM06YKUKA,6/22/2022 18:31,,Completed,,-27,901.9
QFM06YKUKA,6/22/2022 18:31,,Completed,,-150,928.9
QFM46Y7VQK,6/22/2022 18:27,,Completed,,-124,"1,078.90"
QFM76Q13MT,6/22/2022 16:56,,Completed,"2,999.00",,"3,402.90"
QFM56FBJ7R,6/22/2022 14:23,,Completed,,-23,403.9
QFM56FBJ7R,6/22/2022 14:23,,Completed,,-450,426.9
QFM86ETVAI,6/22/2022 14:15,,Completed,,-6,876.9
QFM86ETVAI,6/22/2022 14:15,,Completed,,-120,882.9
QFM46EPAAE,6/22/2022 14:14,,Completed,"1,000.00",,"1,002.90"
QFM56EGXNX,6/22/2022 14:10,,Completed,,-200,2.9
QFM961AK39,6/22/2022 10:55,,Completed,,-6,202.9
QFM961AK39,6/22/2022 10:55,,Completed,,-300,208.9
QFM25XC8H2,6/22/2022 9:52,,Completed,,-20,508.9
QFL53YA8I7,6/21/2022 9:36,,Completed,,-30,528.9
QFL93XKSCN,6/21/2022 9:25,,Completed,,-500,558.9
QFL73XIV1B,6/21/2022 9:24,,Completed,"1,000.00",,"1,058.90"
QFK938IPDH,6/20/2022 19:29,,Completed,,-300,58.9
QFK52Z3YZL,6/20/2022 18:02,,Completed,,-27,358.9
QFK52Z3YZL,6/20/2022 18:02,,Completed,,-200,385.9
QFK92YSTF1,6/20/2022 17:58,,Completed,,-550,585.9
QFK32M27L9,6/20/2022 15:15,,Completed,,-23,"1,135.90"
QFK32M27L9,6/20/2022 15:15,,Completed,,-140,"1,158.90"
QFK02KMA7O,6/20/2022 14:54,,Completed,,"-1,500.00","1,298.90"
QFK62KF8YM,6/20/2022 14:51,,Completed,,-27,"2,798.90"
QFK62KF8YM,6/20/2022 14:51,,Completed,,-150,"2,825.90"
QFK12K3QM3,6/20/2022 14:46,,Completed,,-6,"2,975.90"
QFK12K3QM3,6/20/2022 14:46,,Completed,,-280,"2,981.90"
QFK82DUK1C,6/20/2022 13:18,,Completed,,-28,"3,261.90"
Statement Verification Code,"To verify the validity of this M-PESA statement dial *334#, select My account and follow theprompts to enter the code.",,,,,
,,,,,,
LLHKTUZR,,,,,,
Receipt No.,Completion Time,,Transaction Status,Paid In,Withdrawn,Balance
QFK82DUK1C,6/20/2022 13:18,,Completed,,"-1,200.00","3,289.90"
QFK02DQDZQ,6/20/2022 13:17,,Completed,"1,500.00",,"4,489.90"
QFK12CQDP3,6/20/2022 13:03,,Completed,,-30,"2,989.90"
QFJ21BAWD0,6/19/2022 19:34,,Completed,,-6,"3,019.90"
QFJ21BAWD0,6/19/2022 19:34,,Completed,,-300,"3,025.90"
QFJ019NX4A,6/19/2022 19:18,,Completed,,-5,"3,325.90"
QFJ314Z3MD,6/19/2022 18:31,,Completed,,-6,"3,330.90"
QFJ314Z3MD,6/19/2022 18:31,,Completed,,-350,"3,336.90"
QFJ3ZU3IAR,6/19/2022 16:09,,Completed,,-6,"3,686.90"
QFJ3ZU3IAR,6/19/2022 16:09,,Completed,,-450,"3,692.90"
QFJ0Z94TJO,6/19/2022 10:22,,Completed,,-6,"4,142.90"
QFJ0Z94TJO,6/19/2022 10:22,,Completed,,-300,"4,148.90"
QFI8YJPLCC,6/18/2022 19:50,,Completed,"2,000.00",,"4,448.90"
QFI5Y41ZBP,6/18/2022 17:16,,Completed,,-12,"2,448.90"
QFI5Y41ZBP,6/18/2022 17:16,,Completed,,-650,"2,460.90"
QFI5XPZDQ3,6/18/2022 14:07,,Completed,"3,000.00",,"3,110.90"
QFI6XCFFOC,6/18/2022 10:49,,Completed,,-180,110.9
QFI5XC29HH,6/18/2022 10:44,,Completed,,-10,290.9
QFI6X8H7B0,6/18/2022 9:47,,Completed,,"-1,286.00",300.9
QFI0X7ZCI0,6/18/2022 9:39,,Completed,300,,"1,586.90"
QFI6X740BG,6/18/2022 9:25,,Completed,,-40,"1,286.90"
QFH1WWS8PB,6/17/2022 23:35,,Completed,900,,"1,326.90"
QFH1WQN77L,6/17/2022 21:10,,Completed,,-5,426.9
QFH1WPUY2N,6/17/2022 21:00,,Completed,,"-3,000.00",431.9
QFH3WH0C2F,6/17/2022 19:30,,Completed,,-87,431.9
QFH3WH0C2F,6/17/2022 19:30,,Completed,,"-10,000.00",518.9
QFH5WGPN5T,6/17/2022 19:28,,Completed,"6,000.00",,"10,518.90"
QFH7WFO7SB,6/17/2022 19:19,,Completed,500,,"4,518.90"
QFH3W8L0RP,6/17/2022 18:14,,Completed,"1,000.00",,"4,018.90"
QFH7W2BH91,6/17/2022 17:04,,Completed,"3,000.00",,"3,018.90"
QFH7W22Q2D,6/17/2022 17:01,,Completed,,-87,18.9
QFH7W22Q2D,6/17/2022 17:01,,Completed,,"-10,000.00",105.9
QFH3W200F9,6/17/2022 17:00,,Completed,"10,100.00",,"10,105.90"
QFH4VWDFQ2,6/17/2022 15:46,,Completed,,"-2,000.00",5.9
QFH6VW8VR2,6/17/2022 15:44,,Completed,"2,000.00",,"2,005.90"
QFH7VQ4EH5,6/17/2022 14:17,,Completed,,-28,5.9
QFH7VQ4EH5,6/17/2022 14:17,,Completed,,-580,33.9
QFH6VQ1YDQ,6/17/2022 14:16,,Completed,550,,613.9
QFH6VPZR12,6/17/2022 14:15,,Completed,,-5,63.9
Statement Verification Code,"To verify the validity of this M-PESA statement dial *334#, select My account and follow theprompts to enter the code.",,,,,
,,,,,,
LLHKTUZR,,,,,,
Receipt No.,Completion Time,,Transaction Status,Paid In,Withdrawn,Balance
QFH1VN2NAR,6/17/2022 13:34,,Completed,,-145,68.9
QFH6V3KLRY,6/17/2022 8:34,,Completed,,-40,213.9
QFH4UZMCJQ,6/17/2022 7:09,,Completed,,"-5,000.00",253.9
QFH8UYR5HU,6/17/2022 6:39,,Completed,,-100,"5,253.90"
QFH0UXJ99K,6/17/2022 4:25,,Completed,"4,000.00",,"5,353.90"
QFH7UWSSBD,6/17/2022 1:00,,Completed,"1,000.00",,"1,353.90"
QFG4UMX95A,6/16/2022 20:29,,Completed,,-12,353.9
QFG4UMX95A,6/16/2022 20:29,,Completed,,"-1,000.00",365.9
QFG8UMV50A,6/16/2022 20:28,,Completed,"1,030.00",,"1,365.90"
QFG2UMNGLU,6/16/2022 20:26,,Completed,,"-4,000.00",335.9
QFG4UMLFF6,6/16/2022 20:25,,Completed,"4,000.00",,"4,335.90"
QFG3UFUXFZ,6/16/2022 19:22,,Completed,,-80,335.9
QFG2TUI96A,6/16/2022 15:18,,Completed,,-100,415.9
QFG5TRYL5J,6/16/2022 14:40,,Completed,,"-1,000.00",515.9
QFG8TRVAU6,6/16/2022 14:39,,Completed,"1,000.00",,"1,515.90"
QFG8TQPGK2,6/16/2022 14:22,,Completed,,-12,515.9
QFG8TQPGK2,6/16/2022 14:22,,Completed,,-700,527.9
QFG6TQOPOI,6/16/2022 14:21,,Completed,730,,"1,227.90"
QFG3TO912D,6/16/2022 13:46,,Completed,,-32,497.9
QFG3TO912D,6/16/2022 13:46,,Completed,,"-2,500.00",529.9
QFG1TO7F1P,6/16/2022 13:46,,Completed,"2,530.00",,"3,029.90"
QFG1TFS9V9,6/16/2022 11:42,,Completed,,"-6,000.00",499.9
QFG6TFQPUG,6/16/2022 11:41,,Completed,"6,050.00",,"6,499.90"
QFG0TFLXNO,6/16/2022 11:39,,Completed,,"-2,000.00",449.9
QFG3TCU8GX,6/16/2022 10:57,,Completed,"2,000.00",,"2,449.90"
QFG3TBVY3P,6/16/2022 10:43,,Completed,,-30,449.9
QFG7TAGW8R,6/16/2022 10:21,,Completed,,"-1,000.00",479.9
QFG8T9TTBG,6/16/2022 10:11,,Completed,"1,000.00",,"1,479.90"
QFG9T9OYYT,6/16/2022 10:09,,Completed,,"-1,500.00",479.9
QFG6T9G7KK,6/16/2022 10:05,,Completed,"1,500.00",,"1,979.90"
QFG6T8ZNRY,6/16/2022 9:58,,Completed,,-5,479.9
QFG6T7Z31G,6/16/2022 9:41,,Completed,,"-3,000.00",484.9
QFG6T7VYZ0,6/16/2022 9:40,,Completed,"3,000.00",,"3,484.90"
QFG6T70OEC,6/16/2022 9:26,,Completed,,"-2,000.00",484.9
QFG9T6GTF9,6/16/2022 9:17,,Completed,"2,000.00",,"2,484.90"
QFF5SO3XBV,6/15/2022 20:43,,Completed,,-30,484.9
QFF6SNZMJY,6/15/2022 20:41,,Completed,,-80,514.9
QFF7SJIPRZ,6/15/2022 19:55,,Completed,,"-1,000.00",594.9
QFF6SJGUMG,6/15/2022 19:55,,Completed,,"-5,100.00","1,594.90"
QFF2SJ2OCC,6/15/2022 19:51,,Completed,"5,100.00",,"6,694.90"
QFF1SEVWO7,6/15/2022 19:16,,Completed,,-35,"1,594.90"
QFF0S754J2,6/15/2022 18:04,,Completed,"1,000.00",,"1,629.90"
QFF5S4MRS1,6/15/2022 17:38,,Completed,,"-2,000.00",629.9
QFF8S1VAOE,6/15/2022 17:06,,Completed,,-35,"2,629.90"
Statement Verification Code,"To verify the validity of this M-PESA statement dial *334#, select My account and follow theprompts to enter the code.",,,,,
,,,,,,
LLHKTUZR,,,,,,
Receipt No.,Completion Time,,Transaction Status,Paid In,Withdrawn,Balance
QFF8S1TIKC,6/15/2022 17:05,,Completed,5,,"2,664.90"
QFF9S1Q2UH,6/15/2022 17:04,,Completed,"2,000.00",,"2,659.90"
QFF5S04DUF,6/15/2022 16:44,,Completed,,-55,659.9
QFF5S04DUF,6/15/2022 16:44,,Completed,,"-4,000.00",714.9
QFF0RZY78Y,6/15/2022 16:42,,Completed,"4,050.00",,"4,714.90"
QFF0RUMKPG,6/15/2022 15:29,,Completed,,-10,664.9
QFF7RQQ73N,6/15/2022 14:33,,Completed,,"-1,000.00",674.9
QFF8RQIHOQ,6/15/2022 14:30,,Completed,,-45,"1,674.90"
QFF0RNGHPC,6/15/2022 13:47,,Completed,"1,000.00",,"1,719.90"
QFF8RL3JH6,6/15/2022 13:14,,Completed,,-600,719.9
QFF8RKL1GS,6/15/2022 13:07,,Completed,600,,"1,319.90"
QFF2RALPKO,6/15/2022 10:38,,Completed,,-55,719.9
QFF2RALPKO,6/15/2022 10:38,,Completed,,"-5,000.00",774.9
QFF0RAKV16,6/15/2022 10:37,,Completed,50,,"5,774.90"
QFF8RAJGKQ,6/15/2022 10:37,,Completed,"5,000.00",,"5,724.90"
QFF0R9QAE4,6/15/2022 10:25,,Completed,,"-2,000.00",724.9
QFF0QXSBRU,6/15/2022 6:42,,Completed,"2,000.00",,"2,724.90"
QFE1QFFKTL,6/14/2022 19:27,,Completed,,-65,724.9
QFE4PTW3F0,6/14/2022 15:26,,Completed,,"-1,000.00",789.9
QFE9PTUELZ,6/14/2022 15:26,,Completed,"1,000.00",,"1,789.90"
QFE4PSNB3Y,6/14/2022 15:08,,Completed,,-55,789.9
QFE4PSNB3Y,6/14/2022 15:08,,Completed,,"-5,000.00",844.9
QFE1PSMCN1,6/14/2022 15:07,,Completed,"5,050.00",,"5,844.90"
QFE9PQVARP,6/14/2022 14:41,,Completed,,"-1,000.00",794.9
QFE5PQRBLF,6/14/2022 14:39,,Completed,"1,000.00",,"1,794.90"
QFE7POL2IH,6/14/2022 14:08,,Completed,,-35,794.9
QFE9PMRST3,6/14/2022 13:42,,Completed,,"-7,000.00",829.9
QFE9PLQJ5X,6/14/2022 13:27,,Completed,,-60,"7,829.90"
QFD8OVQT1W,6/13/2022 23:54,,Completed,"2,000.00",,"7,889.90"
QFD4OV798A,6/13/2022 23:14,,Completed,"5,000.00",,"5,889.90"
QFD9OQTBKJ,6/13/2022 21:20,,Completed,,-55,889.9
QFD9OQTBKJ,6/13/2022 21:20,,Completed,,"-5,000.00",944.9
QFD8OQS3L6,6/13/2022 21:20,,Completed,"5,000.00",,"5,944.90"
QFD3ODCEDR,6/13/2022 18:59,,Completed,,-35,944.9
QFD8O0JOTC,6/13/2022 16:41,,Completed,,"-1,230.00",979.9
QFD0NZX19O,6/13/2022 16:32,,Completed,"1,030.00",,"2,209.90"
QFD5NYVIXL,6/13/2022 16:18,,Completed,,-90,"1,179.90"
QFD9NP9BR9,6/13/2022 13:59,,Completed,,-30,"1,269.90"
QFD6NDJDYE,6/13/2022 11:09,,Completed,200,,"1,299.90"
QFD8N7MKWO,6/13/2022 9:38,,Completed,,"-4,000.00","1,099.90"
QFD0N7833G,6/13/2022 9:31,,Completed,"5,000.00",,"5,099.90"
QFD7N1QAVV,6/13/2022 7:53,,Completed,,-500,99.9
QFD3N1PML1,6/13/2022 7:52,,Completed,500,,599.9
Statement Verification Code,"To verify the validity of this M-PESA statement dial *334#, select My account and follow theprompts to enter the code.",,,,,
,,,,,,
LLHKTUZR,,,,,,
Receipt No.,Completion Time,,Transaction Status,Paid In,Withdrawn,Balance
QFC4MPJXB4,6/12/2022 20:45,,Completed,,"-1,000.00",99.9
QFC8MPIIAU,6/12/2022 20:45,,Completed,"1,000.00",,"1,099.90"
QFC9MOGTFX,6/12/2022 20:31,,Completed,,"-2,000.00",99.9
QFC4MOCXEE,6/12/2022 20:30,,Completed,"2,000.00",,"2,099.90"
QFC2MJPRRM,6/12/2022 19:39,,Completed,,-25,99.9
QFC8MBT7CM,6/12/2022 18:19,,Completed,,-45,124.9
QFC6MBJ7BG,6/12/2022 18:16,,Completed,,-50,169.9
QFC4M2K3UM,6/12/2022 16:18,,Completed,,"-1,200.00",219.9
QFC2LYFIGI,6/12/2022 15:18,,Completed,"1,200.00",,"1,419.90"
QFC2LWYRGC,6/12/2022 14:56,,Completed,,-75,219.9
QFC2LNS9T2,6/12/2022 12:30,,Completed,,-20,294.9
QFB2L3DM76,6/11/2022 23:05,,Completed,,-51,314.9
QFB2L3DM76,6/11/2022 23:05,,Completed,,"-3,000.00",365.9
QFB8L3DC2M,6/11/2022 23:05,,Completed,"3,000.00",,"3,365.90"
QFB9KZ3GJB,6/11/2022 21:28,,Completed,,"-5,000.00",365.9
QFB2KYXC2G,6/11/2022 21:25,,Completed,"5,002.00",,"5,365.90"
QFB3KVII1Z,6/11/2022 20:41,,Completed,,"-1,028.00",363.9
QFB7KV7MYN,6/11/2022 20:37,,Completed,"1,028.00",,"1,391.90"
QFB1KT1H0T,6/11/2022 20:14,,Completed,,-10,363.9
QFB6KSRO84,6/11/2022 20:11,,Completed,,"-3,000.00",373.9
QFB9KSPSI5,6/11/2022 20:11,,Completed,"1,000.00",,"3,373.90"
QFB5KPWSX7,6/11/2022 19:44,,Completed,"2,000.00",,"2,373.90"
QFB4KLG1SS,6/11/2022 19:05,,Completed,,-10,373.9
QFB4KLG1SS,6/11/2022 19:05,,Completed,,-100,383.9
QFB2KKO3AK,6/11/2022 18:58,,Completed,,-617,483.9
QFB7KJL525,6/11/2022 18:49,,Completed,,-5,"1,100.90"
QFB4KJIRD2,6/11/2022 18:48,,Completed,"1,000.00",,"1,105.90"
QFB9KE84U3,6/11/2022 17:55,,Completed,,-30,105.9
QFB3KDP3IT,6/11/2022 17:49,,Completed,,-60,135.9
QFB8KCMOQ4,6/11/2022 17:37,,Completed,,-100,195.9
QFB7JVWQVN,6/11/2022 13:58,,Completed,,-60,295.9
QFB1JRJG9B,6/11/2022 12:58,,Completed,,"-1,000.00",355.9
QFB8JREPTO,6/11/2022 12:56,,Completed,"1,000.00",,"1,355.90"
QFB4JM31JK,6/11/2022 11:39,,Completed,,-5,355.9
QFB5JB48SZ,6/11/2022 8:48,,Completed,,-20,360.9
QFA5IXEZL9,6/10/2022 21:25,,Completed,,-12,380.9
QFA5IXEZL9,6/10/2022 21:25,,Completed,,"-1,000.00",392.9
QFA0IXDOOI,6/10/2022 21:25,,Completed,"1,000.00",,"1,392.90"
QFA1IMLEV5,6/10/2022 19:30,,Completed,,-60,392.9
QFA7IGPM5V,6/10/2022 18:40,,Completed,,"-2,000.00",452.9
Statement Verification Code,"To verify the validity of this M-PESA statement dial *334#, select My account and follow theprompts to enter the code.",,,,,
,,,,,,
LLHKTUZR,,,,,,
Receipt No.,Completion Time,,Transaction Status,Paid In,Withdrawn,Balance
QFA3IGKQ03,6/10/2022 18:39,,Completed,"2,000.00",,"2,452.90"
QFA1I2O1N3,6/10/2022 16:05,,Completed,,"-2,000.00",452.9
QFA0I2H1HU,6/10/2022 16:02,,Completed,"2,000.00",,"2,452.90"
QFA3HXKF4J,6/10/2022 14:55,,Completed,,-50,452.9
QFA8HWYNQG,6/10/2022 14:46,,Completed,,"-3,000.00",502.9
QFA9HWUL5J,6/10/2022 14:45,,Completed,500,,"3,502.90"
QFA9HWS57Z,6/10/2022 14:44,,Completed,,-5,"3,002.90"
QFA2HWPCMO,6/10/2022 14:43,,Completed,5,,"3,007.90"
QFA7HPHVED,6/10/2022 13:04,,Completed,,-50,"3,002.90"
QFA1HMU14H,6/10/2022 12:25,,Completed,,-30,"3,052.90"
QFA7HENEF9,6/10/2022 10:25,,Completed,"3,000.00",,"3,082.90"
QFA9H83Q41,6/10/2022 8:41,,Completed,,-20,82.9
QF93GQOJVR,6/9/2022 20:27,,Completed,,-100,102.9
QF94GKW7NG,6/9/2022 19:31,,Completed,,-40,202.9
QF93FTOIIT,6/9/2022 14:14,,Completed,,-60,242.9
QF99FDCVUN,6/9/2022 10:15,,Completed,,-30,302.9
QF97F4DXZH,6/9/2022 7:38,,Completed,,-20,332.9
QF86EJS816,6/8/2022 19:20,,Completed,,-5,352.9
QF88EJPIAW,6/8/2022 19:19,,Completed,,-65,357.9
QF81E27P7B,6/8/2022 16:14,,Completed,,-50,422.9
QF84DTC65E,6/8/2022 14:09,,Completed,,-12,472.9
QF84DTC65E,6/8/2022 14:09,,Completed,,"-1,000.00",484.9
QF84DT67J0,6/8/2022 14:06,,Completed,"1,000.00",,"1,484.90"
QF89DGT67D,6/8/2022 11:09,,Completed,,-90,484.9
QF85DGPQFZ,6/8/2022 11:08,,Completed,500,,574.9
QF87DGO077,6/8/2022 11:07,,Completed,,-5,74.9
QF86DA0YRC,6/8/2022 9:25,,Completed,,-10,79.9
QF78CJ89JG,6/7/2022 19:14,,Completed,,-90,89.9
QF77B7CMFF,6/7/2022 8:38,,Completed,,-30,179.9
QF70B6USN2,6/7/2022 8:29,,Completed,,-40,209.9
QF69ALQS9P,6/6/2022 19:42,,Completed,,-6,249.9
QF69ALQS9P,6/6/2022 19:42,,Completed,,-120,255.9
QF669TC9B6,6/6/2022 14:22,,Completed,,-160,375.9
QF659T5VJ7,6/6/2022 14:20,,Completed,100,,535.9
QF609NHFHO,6/6/2022 13:04,,Completed,,-30,435.9
QF649DWVV8,6/6/2022 10:46,,Completed,,-23,465.9
QF649DWVV8,6/6/2022 10:46,,Completed,,-500,488.9
QF61989I4D,6/6/2022 9:21,,Completed,,-5,988.9
Statement Verification Code,"To verify the validity of this M-PESA statement dial *334#, select My account and follow theprompts to enter the code.",,,,,
,,,,,,
LLHKTUZR,,,,,,
Receipt No.,Completion Time,,Transaction Status,Paid In,Withdrawn,Balance
QF578JX8OP,6/5/2022 19:36,,Completed,,-65,993.9
QF578JURRV,6/5/2022 19:35,,Completed,"1,000.00",,"1,058.90"
QF598JSCJD,6/5/2022 19:35,,Completed,,-5,58.9
QF508BM504,6/5/2022 18:13,,Completed,,-15,63.9
QF57894PBP,6/5/2022 17:43,,Completed,,-65,78.9
QF597ZHA73,6/5/2022 15:32,,Completed,,-100,143.9
QF597Y6GQF,6/5/2022 15:13,,Completed,,-70,243.9
QF527B0A90,6/5/2022 8:49,,Completed,,-5,313.9
QF517AX7V3,6/5/2022 8:48,,Completed,200,,318.9
QF557ASPHN,6/5/2022 8:46,,Completed,,-25,118.9
QF416OHCMP,6/4/2022 19:46,,Completed,,-30,143.9
QF436MBVHL,6/4/2022 19:28,,Completed,,-40,173.9
QF436G67CB,6/4/2022 18:34,,Completed,,-35,213.9
QF475ZT9QD,6/4/2022 15:20,,Completed,,-50,248.9
QF324IP5UA,6/3/2022 19:20,,Completed,,-80,298.9
QF3348ZA97,6/3/2022 17:49,,Completed,,"-5,000.00",378.9
QF3248UI66,6/3/2022 17:48,,Completed,"5,000.00",,"5,378.90"
QF383WUA62,6/3/2022 15:18,,Completed,,-50,378.9
QF313MH3G5,6/3/2022 12:55,,Completed,,-10,428.9
QF222OXNL4,6/2/2022 20:29,,Completed,,-35,438.9
QF222HWDPS,6/2/2022 19:23,,Completed,,-65,473.9
QF292DTAYB,6/2/2022 18:48,,Completed,,-120,538.9
QF292C4RG3,6/2/2022 18:32,,Completed,,-5,658.9
QF241M3LPM,6/2/2022 12:50,,Completed,,-30,663.9
QF2419M0KW,6/2/2022 9:42,,Completed,,-5,693.9
QF15ZKOU5L,6/1/2022 19:42,,Completed,,-45,698.9
QF18YSC9F0,6/1/2022 14:03,,Completed,500,,743.9
QF13YRSZ1N,6/1/2022 13:55,,Completed,,-30,243.9
QF18YQH9TS,6/1/2022 13:36,,Completed,,-65,273.9
QF16YQ973M,6/1/2022 13:33,,Completed,300,,338.9
QF19YQ5ICJ,6/1/2022 13:32,,Completed,,-5,38.9
QF16Y71FKY,6/1/2022 8:38,,Completed,,-45,43.9
QF13Y4481R,6/1/2022 7:37,,Completed,,-35,88.9
QEV1X1EP5D,5/31/2022 16:19,,Completed,,-50,123.9
QEV3WYO2DX,5/31/2022 15:41,,Completed,,-10,173.9
Statement Verification Code,"To verify the validity of this M-PESA statement dial *334#, select My account and follow theprompts to enter the code.",,,,,
,,,,,,
LLHKTUZR,,,,,,
Receipt No.,Completion Time,,Transaction Status,Paid In,Withdrawn,Balance
QEU8VJQ8KO,5/30/2022 19:21,,Completed,,-45,183.9
QEU5UXGWKJ,5/30/2022 15:09,,Completed,,-30,228.9
QEU7UVX2QP,5/30/2022 14:48,,Completed,,-65,258.9
QEU3UNW909,5/30/2022 12:58,,Completed,,"-2,999.00",323.9
QEU7UNU2ZH,5/30/2022 12:57,,Completed,"3,000.00",,"3,322.90"
QEU4UHFG6U,5/30/2022 11:26,,Completed,,-5,322.9
QEU7U8J0K5,5/30/2022 9:13,,Completed,,-20,327.9
QET4TLL00I,5/29/2022 19:27,,Completed,,-60,347.9
QET7T74XRR,5/29/2022 16:40,,Completed,,-55,407.9
QET7STNXDV,5/29/2022 13:24,,Completed,,-80,462.9
QET1ST0149,5/29/2022 13:13,,Completed,500,,542.9
QET3SSXOPF,5/29/2022 13:12,,Completed,,-5,42.9
QES4RSEBNQ,5/28/2022 19:45,,Completed,,-65,47.9
QES2RGUTNM,5/28/2022 17:56,,Completed,,-20,112.9
QES9QXWT5J,5/28/2022 13:55,,Completed,,-50,132.9
QER8Q103U8,5/27/2022 21:34,,Completed,,-5,182.9
QER8PTY6C2,5/27/2022 20:03,,Completed,,-100,187.9
QER4PSHWPM,5/27/2022 19:48,,Completed,,-10,287.9
QER4PSHWPM,5/27/2022 19:48,,Completed,,-100,297.9
QER5P11QR5,5/27/2022 14:42,,Completed,,-5,397.9
QER2P0OL8Y,5/27/2022 14:37,,Completed,,-10,402.9
QER2P0OL8Y,5/27/2022 14:37,,Completed,,-50,412.9
QER4OUJB1E,5/27/2022 13:13,,Completed,,-5,462.9
QER3ODDCO7,5/27/2022 8:55,,Completed,,-35,467.9
QEQ2O0XXWK,5/26/2022 21:38,,Completed,,-20,502.9
QEQ1NU1OUN,5/26/2022 20:07,,Completed,,-80,522.9
QEQ0NBBUF0,5/26/2022 16:59,,Completed,,-12,602.9
QEQ0NBBUF0,5/26/2022 16:59,,Completed,,-700,614.9
QEQ5NAJH9H,5/26/2022 16:49,,Completed,"1,050.00",,"1,314.90"
QEQ8MYEQ2A,5/26/2022 13:59,,Completed,,-50,264.9
QEP2LREFLY,5/25/2022 19:34,,Completed,,-45,314.9
QEP1L0MRPV,5/25/2022 14:20,,Completed,,-5,359.9
QEP4KYTP6A,5/25/2022 13:54,,Completed,,-5,364.9
QEP6KYQ6XM,5/25/2022 13:52,,Completed,,-60,369.9
QEO0JU76CQ,5/24/2022 19:41,,Completed,,-80,429.9
QEO7JTYZUP,5/24/2022 19:39,,Completed,40,,509.9
QEO0J1YKKQ,5/24/2022 13:56,,Completed,,-10,469.9
QEO8J0QETA,5/24/2022 13:38,,Completed,,-50,479.9
Statement Verification Code,"To verify the validity of this M-PESA statement dial *334#, select My account and follow theprompts to enter the code.",,,,,
,,,,,,
LLHKTUZR,,,,,,
Receipt No.,Completion Time,,Transaction Status,Paid In,Withdrawn,Balance
QEO5J0JDAT,5/24/2022 13:35,,Completed,500,,529.9
QEO7J0HT2F,5/24/2022 13:34,,Completed,,-5,29.9
QEO2IEGAPO,5/24/2022 7:12,,Completed,,-100,34.9
QEO0IEDZCI,5/24/2022 7:10,,Completed,53,,134.9
QEN4HWSTXA,5/23/2022 19:29,,Completed,,-80,81.9
QEN4H184NQ,5/23/2022 12:53,,Completed,,-20,161.9
QEN4H0385G,5/23/2022 12:36,,Completed,,-20,181.9
QEN9GJRH0F,5/23/2022 8:10,,Completed,,-20,201.9
QEN2GJPS1S,5/23/2022 8:09,,Cancelled,,-20,221.9
QEM1GA2GV1,5/22/2022 21:48,,Completed,,-35,221.9
QEM5FZ8T1R,5/22/2022 19:26,,Completed,,-70,256.9
QEM2F86QQG,5/22/2022 13:30,,Completed,,-65,326.9
QEL7E5XABJ,5/21/2022 19:28,,Completed,,-70,391.9
QEL2DCJBQG,5/21/2022 13:26,,Completed,,-50,461.9
QEL4DC550Y,5/21/2022 13:20,,Completed,500,,511.9
QEK7CD7JHT,5/20/2022 20:29,,Completed,,-40,11.9
QEJ0AAURU8,5/19/2022 19:44,,Completed,,-6,51.9
QEJ0AAURU8,5/19/2022 19:44,,Completed,,-500,57.9
QEJ9AASF01,5/19/2022 19:43,,Completed,500,,557.9
QEJ29UH5WY,5/19/2022 16:53,,Completed,,-30,57.9
QEJ69U3P22,5/19/2022 16:48,,Completed,,-580,87.9
QEJ29U193U,5/19/2022 16:47,,Completed,120,,667.9
QEJ89TVZS6,5/19/2022 16:46,,Completed,220,,547.9
QEJ69TQIYU,5/19/2022 16:44,,Completed,120,,327.9
QEJ49OUC7M,5/19/2022 15:32,,Completed,,-10,207.9
QEJ59O0V8N,5/19/2022 15:19,,Completed,,-6,217.9
QEJ59O0V8N,5/19/2022 15:19,,Completed,,-200,223.9
QEJ49FP91K,5/19/2022 13:13,,Completed,,-100,423.9
QEJ29FLGFQ,5/19/2022 13:12,,Completed,500,,523.9
QEJ19FJ1MZ,5/19/2022 13:11,,Completed,,-10,23.9
QEI480KHUO,5/18/2022 17:13,,Completed,,-107,33.9
QEI480D8XM,5/18/2022 17:11,,Completed,100,,140.9
QEI77MVGX3,5/18/2022 13:51,,Completed,,-10,40.9
QEI47MIHUA,5/18/2022 13:46,,Completed,,-23,50.9
QEI47MIHUA,5/18/2022 13:46,,Completed,,-400,73.9
QEI77KC869,5/18/2022 13:13,,Completed,,-12,473.9
QEI77KC869,5/18/2022 13:13,,Completed,,"-1,000.00",485.9
QEI07KBG38,5/18/2022 13:13,,Completed,"1,000.00",,"1,485.90"
QEH35RTN0J,5/17/2022 13:57,,Completed,,-5,485.9
QEH55RMYFR,5/17/2022 13:55,,Completed,490,,490.9
Statement Verification Code,"To verify the validity of this M-PESA statement dial *334#, select My account and follow theprompts to enter the code.",,,,,
,,,,,,
LLHKTUZR,,,,,,
Receipt No.,Completion Time,,Transaction Status,Paid In,Withdrawn,Balance
QEH25FKVH4,5/17/2022 10:47,,Completed,,-20,0.9
QEH65FJ1JC,5/17/2022 10:46,,Completed,20,,20.9
QEG44TVOY2,5/16/2022 20:51,,Completed,,-500,0.9
QEG74TSLMN,5/16/2022 20:50,,Completed,500,,500.9
QEG24MZXB2,5/16/2022 19:37,,Completed,,-20,0.9
QEG94MVYUN,5/16/2022 19:36,,Completed,10,,20.9
QEG74AXR0N,5/16/2022 17:38,,Completed,,-84,10.9
QEG74AXR0N,5/16/2022 17:38,,Completed,,"-5,500.00",94.9
QEG243ZYAG,5/16/2022 16:07,,Completed,,-22,"5,594.90"
QEG243ZYAG,5/16/2022 16:07,,Completed,,"-1,500.00","5,616.90"
QEG641W8VK,5/16/2022 15:36,,Completed,100,,"7,116.90"
QEF52IA7W1,5/15/2022 18:01,,Completed,,"-2,400.00","7,016.90"
QEF22HZHOW,5/15/2022 17:57,,Completed,,-84,"9,416.90"
QEF22HZHOW,5/15/2022 17:57,,Completed,,"-6,000.00","9,500.90"
QEF6275520,5/15/2022 15:23,,Completed,"13,000.00",,"15,500.90"
QEF0271A3C,5/15/2022 15:22,,Completed,,-10,"2,500.90"
QEF222Y9AK,5/15/2022 14:21,,Completed,"1,000.00",,"2,510.90"
QEE4YPLQ0S,5/14/2022 10:01,,Completed,,-30,"1,510.90"
QED3WWMVL5,5/13/2022 11:31,,Completed,,-10,"1,540.90"
QED6WWHHDK,5/13/2022 11:29,,Completed,,-5,"1,550.90"
QEC6V7RVGE,5/12/2022 13:49,,Completed,,-10,"1,555.90"
QEC3UO9O65,5/12/2022 8:41,,Completed,,-130,"1,565.90"
QEB0U66TTU,5/11/2022 20:15,,Completed,,-27,"1,695.90"
QEB0U66TTU,5/11/2022 20:15,,Completed,,-300,"1,722.90"
QEB6U0V2TE,5/11/2022 19:25,,Completed,,-40,"2,022.90"
QEB8TXOKI4,5/11/2022 18:58,,Completed,500,,"2,062.90"
QEB2TGI1LW,5/11/2022 15:36,,Completed,,-27,"1,562.90"
QEB2TGI1LW,5/11/2022 15:36,,Completed,,-150,"1,589.90"
QEB2TGBNLW,5/11/2022 15:33,,Completed,,-500,"1,739.90"
QEB0T2YHD0,5/11/2022 12:17,,Completed,"2,000.00",,"2,239.90"
QEB7SX6JXN,5/11/2022 10:48,,Completed,,-12,239.9
QEB7SX6JXN,5/11/2022 10:48,,Completed,,-530,251.9
QEB0SOBQOM,5/11/2022 8:20,,Completed,,-40,781.9
QEA5S1MPDV,5/10/2022 19:23,,Completed,,-60,821.9
QEA9RBE17J,5/10/2022 14:04,,Completed,,-100,881.9
QEA4R8T5MS,5/10/2022 13:28,,Completed,,-50,981.9
QEA4QQJ11G,5/10/2022 8:44,,Completed,,-30,"1,031.90"
QE95Q2LJC5,5/9/2022 19:18,,Completed,,-80,"1,061.90"
QE92PWDHLY,5/9/2022 18:20,,Completed,,-35,"1,141.90"
QE94PTS7F0,5/9/2022 17:53,,Completed,,-12,"1,176.90"
Statement Verification Code,"To verify the validity of this M-PESA statement dial *334#, select My account and follow theprompts to enter the code.",,,,,
,,,,,,
LLHKTUZR,,,,,,
Receipt No.,Completion Time,,Transaction Status,Paid In,Withdrawn,Balance
QE94PTS7F0,5/9/2022 17:53,,Completed,,"-1,000.00","1,188.90"
QE96POQK0Q,5/9/2022 16:54,,Completed,"1,500.00",,"2,188.90"
QE99PGTI6P,5/9/2022 15:04,,Completed,,-6,688.9
QE99PGTI6P,5/9/2022 15:04,,Completed,,-270,694.9
QE93PF7T93,5/9/2022 14:41,,Completed,,-25,964.9
QE97PESW8F,5/9/2022 14:35,,Completed,,-850,989.9
QE98PDX9L2,5/9/2022 14:22,,Completed,,"-3,292.00","1,839.90"
QE93PANFK5,5/9/2022 13:36,,Completed,,-210,"5,131.90"
QE94P8BEW4,5/9/2022 13:03,,Completed,"3,000.00",,"5,341.90"
QE95P88FFT,5/9/2022 13:02,,Completed,,-10,"2,341.90"
QE95P88FFT,5/9/2022 13:02,,Completed,,-100,"2,351.90"
QE82O9SD5S,5/8/2022 20:14,,Completed,"2,001.00",,"2,451.90"
QE88NXWSE8,5/8/2022 18:10,,Completed,,-90,450.9
QE85NMHXTL,5/8/2022 15:42,,Completed,,-255,540.9
QE83NLZVJT,5/8/2022 15:36,,Completed,,-940,795.9
QE88NLUZT0,5/8/2022 15:34,,Completed,"1,200.00",,"1,735.90"
QE66K5WIWE,5/6/2022 19:09,,Completed,,-50,535.9
QE65K5R035,5/6/2022 19:08,,Completed,,-50,585.9
QE67K4S415,5/6/2022 19:00,,Completed,100,,635.9
QE64JZXJPI,5/6/2022 18:14,,Completed,,-20,535.9
QE64JCSMKS,5/6/2022 13:21,,Completed,,-35,555.9
QE65J1LVOJ,5/6/2022 10:39,,Completed,,-6,590.9
QE65J1LVOJ,5/6/2022 10:39,,Completed,,-290,596.9
QE50HOA9IM,5/5/2022 16:08,,Completed,,"-1,029.00",886.9
QE59HIGEYZ,5/5/2022 14:45,,Completed,,-12,"1,915.90"
QE59HIGEYZ,5/5/2022 14:45,,Completed,,-550,"1,927.90"
QE56HHTU8K,5/5/2022 14:36,,Completed,,-23,"2,477.90"
QE56HHTU8K,5/5/2022 14:36,,Completed,,-500,"2,500.90"
QE51HE5V3V,5/5/2022 13:45,,Completed,,-10,"3,000.90"
QE52HDP65Q,5/5/2022 13:38,,Completed,"1,500.00",,"3,010.90"
QE58H6ZFX2,5/5/2022 12:01,,Completed,,"-4,500.00","1,510.90"
QE57H6QL93,5/5/2022 11:58,,Completed,"4,500.00",,"6,010.90"
QE57H4Z4EN,5/5/2022 11:31,,Completed,,-35,"1,510.90"
QE58H2P0C2,5/5/2022 10:57,,Completed,,-23,"1,545.90"
QE58H2P0C2,5/5/2022 10:57,,Completed,,"-1,500.00","1,568.90"
QE50H2LQFO,5/5/2022 10:56,,Completed,"3,000.00",,"3,068.90"
QE50H2I0TO,5/5/2022 10:54,,Completed,,-5,68.9
QE53H1OI7L,5/5/2022 10:41,,Completed,,-30,73.9
QE51GWZXBJ,5/5/2022 9:28,,Completed,,-27,103.9
Statement Verification Code,"To verify the validity of this M-PESA statement dial *334#, select My account and follow theprompts to enter the code.",,,,,
,,,,,,
LLHKTUZR,,,,,,
Receipt No.,Completion Time,,Transaction Status,Paid In,Withdrawn,Balance
QE51GWZXBJ,5/5/2022 9:28,,Completed,,-500,130.9
QE50GVV1EM,5/5/2022 9:09,,Completed,500,,630.9
QE30DK7BP4,5/3/2022 14:00,,Completed,,-6,130.9
QE30DK7BP4,5/3/2022 14:00,,Completed,,-130,136.9
QE38DK6FYA,5/3/2022 14:00,,Completed,200,,266.9
QE35DCM3RD,5/3/2022 12:06,,Completed,,-35,66.9
QE30DAG1DC,5/3/2022 11:31,,Completed,,-100,101.9
QE33D8KEP3,5/3/2022 11:01,,Completed,,-5,201.9
QE38D7P8VY,5/3/2022 10:47,,Completed,,-30,206.9
QE31D2DGH5,5/3/2022 9:17,,Completed,,-100,236.9
QE37D26PIX,5/3/2022 9:13,,Completed,,-100,336.9
QE37D21R1X,5/3/2022 9:11,,Completed,,-27,436.9
QE37D21R1X,5/3/2022 9:11,,Completed,,-150,463.9
QE21CPX17N,5/2/2022 21:40,,Completed,,-10,613.9
QE24CG2GRQ,5/2/2022 19:33,,Completed,500,,623.9
QE24CEZ7CY,5/2/2022 19:23,,Completed,,-12,123.9
QE24CEZ7CY,5/2/2022 19:23,,Completed,,-660,135.9
QE23BTHF3N,5/2/2022 14:53,,Completed,,-20,795.9
QE29BO2LHJ,5/2/2022 13:33,,Completed,,-6,815.9
QE29BO2LHJ,5/2/2022 13:33,,Completed,,-500,821.9
QE20BLE18U,5/2/2022 12:53,,Completed,,-35,"1,321.90"
QE28B9P76U,5/2/2022 9:50,,Completed,,-34,"1,356.90"
QE28B9P76U,5/2/2022 9:50,,Completed,,"-6,000.00","1,390.90"
QE20B8ZQDM,5/2/2022 9:38,,Completed,,-10,"7,390.90"
QE20B8ORPU,5/2/2022 9:33,,Completed,"1,000.00",,"7,400.90"
QE28B7WBV6,5/2/2022 9:19,,Completed,,-10,"6,400.90"
QE14AB25T2,5/1/2022 17:22,,Completed,,-474,"6,410.90"
QE129UVRIM,5/1/2022 13:27,,Completed,,-10,"6,884.90"
QE169UC4B0,5/1/2022 13:18,,Completed,,-55,"6,894.90"
QE169UC4B0,5/1/2022 13:18,,Completed,,"-5,000.00","6,949.90"
QE179PE1TT,5/1/2022 11:53,,Completed,,-10,"11,949.90"
QDU18WPRWR,4/30/2022 20:16,,Completed,,-55,"11,959.90"
QDU18WPRWR,4/30/2022 20:16,,Completed,,"-5,000.00","12,014.90"
QDU48CXP56,4/30/2022 16:43,,Completed,,-32,"17,014.90"
QDU48CXP56,4/30/2022 16:43,,Completed,,"-2,000.00","17,046.90"
QDU3803WLT,4/30/2022 13:44,,Completed,,"-2,999.00","19,046.90"
QDT166C8KT,4/29/2022 14:31,,Completed,,-6,"22,045.90"
QDT166C8KT,4/29/2022 14:31,,Completed,,-200,"22,051.90"
QDT865GHCM,4/29/2022 14:18,,Completed,,-10,"22,251.90"
QDT365FFAR,4/29/2022 14:18,,Completed,,-16.7,"22,261.90"
QDT365FFAR,4/29/2022 14:18,,Completed,,"-3,340.00","22,278.60"
QDT25Z0XIG,4/29/2022 12:42,,Completed,300,,"25,618.60"
QDT45YF28K,4/29/2022 12:33,,Completed,"25,000.00",,"25,318.60"
Statement Verification Code,"To verify the validity of this M-PESA statement dial *334#, select My account and follow theprompts to enter the code.",,,,,
,,,,,,
LLHKTUZR,,,,,,
Receipt No.,Completion Time,,Transaction Status,Paid In,Withdrawn,Balance
QDS93WA7KR,4/28/2022 11:03,,Completed,250,,318.6
QDR8370742,4/27/2022 20:09,,Completed,,-20,68.6
QDR42U3M8O,4/27/2022 18:00,,Completed,,-6,88.6
QDR42U3M8O,4/27/2022 18:00,,Completed,,-150,94.6
QDR82U1JGA,4/27/2022 17:59,,Completed,200,,244.6
QDR32HPEKF,4/27/2022 15:14,,Completed,,-30,44.6
QDQ715C5CR,4/26/2022 19:19,,Completed,,-50,74.6
QDQ0ZVR50M,4/26/2022 17:41,,Completed,,-30,124.6
QDQ3ZUPTK9,4/26/2022 17:29,,Completed,,-6,154.6
QDQ3ZUPTK9,4/26/2022 17:29,,Completed,,-150,160.6
QDQ0ZUOM2W,4/26/2022 17:29,,Completed,200,,310.6
QDQ2ZECI9E,4/26/2022 13:41,,Completed,,-28,110.6
QDQ2ZECI9E,4/26/2022 13:41,,Completed,,"-1,000.00",138.6
QDQ4ZE1IHO,4/26/2022 13:36,,Completed,"1,000.00",,"1,138.60"
QDQ0YOTE36,4/26/2022 5:16,,Completed,,-12,138.6
QDP9Y3MSBL,4/25/2022 18:41,,Completed,,-995,150.6
QDP0Y31VPG,4/25/2022 18:35,,Completed,200,,"1,145.60"
QDP6Y0KHT6,4/25/2022 18:09,,Completed,700,,945.6
QDP8XMTGLW,4/25/2022 15:12,,Completed,,-10,245.6
QDP1XKFN0P,4/25/2022 14:38,,Completed,,-60,255.6
QDP4XJHYEM,4/25/2022 14:25,,Completed,,-100,315.6
QDP0XJABGQ,4/25/2022 14:21,,Completed,,-5,415.6
QDP2XHEN82,4/25/2022 13:55,,Completed,400,,420.6
QDO6VM4XSI,4/24/2022 13:11,,Completed,,-10,20.6
QDM9RS2KVB,4/22/2022 12:10,,Completed,,-10,30.6
QDM7RS0LGF,4/22/2022 12:09,,Completed,,-84,40.6
QDM7RS0LGF,4/22/2022 12:09,,Completed,,"-7,100.00",124.6
QDM2RQAQQ2,4/22/2022 11:42,,Completed,"7,200.00",,"7,224.60"
QDK5OHXLQT,4/20/2022 15:51,,Completed,,-10,24.6
QDK8OGIXUM,4/20/2022 15:30,,Completed,,-6,34.6
QDK8OGIXUM,4/20/2022 15:30,,Completed,,-310,40.6
QDK6OGF0QU,4/20/2022 15:29,,Completed,350,,350.6
QDK2O7LZ0K,4/20/2022 13:18,,Completed,,"-1,533.00",0.6
QDK8O7GBKA,4/20/2022 13:16,,Completed,"1,000.00",,"1,533.60"
QDJ0M04RF2,4/19/2022 9:50,,Completed,,-30,533.6
QDJ2LS1N9A,4/19/2022 7:00,,Completed,500,,563.6
QDI8K2LDF2,4/18/2022 7:19,,Completed,,-10,63.6
QDG2HOYARA,4/16/2022 17:29,,Completed,,-28,73.6
QDG2HOYARA,4/16/2022 17:29,,Completed,,"-2,000.00",101.6
QDG3HMOIU7,4/16/2022 16:59,,Completed,"2,050.00",,"2,101.60"
QDF8G3ZEU0,4/15/2022 19:18,,Completed,,-5,51.6
QDF0F1DNAS,4/15/2022 10:24,,Completed,,-50,56.6
QDF0F1DNAS,4/15/2022 10:24,,Completed,,"-3,500.00",106.6
QDF0F17BUG,4/15/2022 10:22,,Completed,"1,600.00",,"3,606.60"
Statement Verification Code,"To verify the validity of this M-PESA statement dial *334#, select My account and follow theprompts to enter the code.",,,,,
,,,,,,
LLHKTUZR,,,,,,
Receipt No.,Completion Time,,Transaction Status,Paid In,Withdrawn,Balance
QDF5F0LIKB,4/15/2022 10:12,,Completed,500,,"2,006.60"
QDF0F0KXXO,4/15/2022 10:12,,Completed,200,,"1,506.60"
QDE0E1AEXI,4/14/2022 18:21,,Completed,,-309,"1,306.60"
QDE1DMKAOR,4/14/2022 15:17,,Completed,,-30,"1,615.60"
QDE0DC3JJY,4/14/2022 12:49,,Completed,,-84,"1,645.60"
QDE0DC3JJY,4/14/2022 12:49,,Completed,,"-7,500.00","1,729.60"
QDE2DBPHJ2,4/14/2022 12:43,,Completed,,-400,"9,229.60"
QDE5DB0PUL,4/14/2022 12:33,,Completed,"7,500.00",,"9,629.60"
QDD9CGTOZ3,4/13/2022 20:43,,Completed,,-23,"2,129.60"
QDD9CGTOZ3,4/13/2022 20:43,,Completed,,-300,"2,152.60"
QDC4AN9YJY,4/12/2022 21:35,,Completed,,-6,"2,452.60"
QDC4AN9YJY,4/12/2022 21:35,,Completed,,-370,"2,458.60"
QDC3ADCCHT,4/12/2022 19:37,,Completed,,-6,"2,828.60"
QDC3ADCCHT,4/12/2022 19:37,,Completed,,-220,"2,834.60"
QDC2A2NR8W,4/12/2022 17:45,,Completed,,-50,"3,054.60"
QDC3A2LV1N,4/12/2022 17:44,,Completed,,-50,"3,104.60"
QDC3A2IX3H,4/12/2022 17:43,,Completed,,-100,"3,154.60"
QDC89WLLKA,4/12/2022 16:25,,Completed,,-12,"3,254.60"
QDC89WLLKA,4/12/2022 16:25,,Completed,,-700,"3,266.60"
QDC99TSXDH,4/12/2022 15:43,,Completed,,-880,"3,966.60"
QDC89R8FYA,4/12/2022 15:04,,Completed,,-35,"4,846.60"
QDC69L856M,4/12/2022 13:35,,Completed,140,,"4,881.60"
QDC89L7IUS,4/12/2022 13:35,,Completed,,"-1,000.00","4,741.60"
QDC19L48N1,4/12/2022 13:34,,Completed,,-32,"5,741.60"
QDC19L48N1,4/12/2022 13:34,,Completed,,"-2,000.00","5,773.60"
QDC09EP55C,4/12/2022 11:59,,Completed,,-160,"7,773.60"
QDC69AS3WE,4/12/2022 10:59,,Completed,,-10,"7,933.60"
QDC095ZDNU,4/12/2022 9:45,,Completed,,-10,"7,943.60"
QDC495WX00,4/12/2022 9:44,,Completed,,-27,"7,953.60"
QDC495WX00,4/12/2022 9:44,,Completed,,-250,"7,980.60"
QDC1954AX5,4/12/2022 9:31,,Completed,,-30,"8,230.60"
QDB682LGJK,4/11/2022 17:05,,Completed,,-28,"8,260.60"
QDB682LGJK,4/11/2022 17:05,,Completed,,"-2,000.00","8,288.60"
QDB87GRI14,4/11/2022 11:57,,Completed,"10,200.00",,"10,288.60"
QDA06K5AYK,4/10/2022 19:47,,Completed,,-112,88.6
QDA06K5AYK,4/10/2022 19:47,,Completed,,"-30,000.00",200.6
QDA76JVJ57,4/10/2022 19:44,,Completed,100,,"30,200.60"
QDA46JNW72,4/10/2022 19:42,,Completed,100,,"30,100.60"
QDA864TXS8,4/10/2022 16:43,,Completed,,-30,"30,000.60"
QDA864RQWI,4/10/2022 16:42,,Completed,30,,"30,030.60"
QDA25IGREM,4/10/2022 10:43,,Completed,"30,000.00",,"30,000.60"
Statement Verification Code,"To verify the validity of this M-PESA statement dial *334#, select My account and follow theprompts to enter the code.",,,,,
,,,,,,
LLHKTUZR,,,,,,
Receipt No.,Completion Time,,Transaction Status,Paid In,Withdrawn,Balance
QD963CECGY,4/9/2022 9:04,,Completed,,-6,0.6
QD77ZLMOZF,4/7/2022 19:31,,Completed,,-6,6.6
QD77ZLMOZF,4/7/2022 19:31,,Completed,,-200,12.6
QD76ZLKOF6,4/7/2022 19:31,,Completed,200,,212.6
QD76Z38O4C,4/7/2022 16:08,,Completed,,-6,12.6
QD76Z38O4C,4/7/2022 16:08,,Completed,,-200,18.6
QD78Z36T1E,4/7/2022 16:07,,Completed,20,,218.6
QD70Z1BR0G,4/7/2022 15:41,,Completed,,-100,198.6
QD72YRWGVM,4/7/2022 13:29,,Completed,,"-1,050.00",298.6
QD72YRVA8W,4/7/2022 13:28,,Completed,"1,050.00",,"1,348.60"
QD79YQUSC9,4/7/2022 13:14,,Completed,,-10,298.6
QD71YQJA0H,4/7/2022 13:10,,Completed,,"-1,700.00",308.6
QD78YPRXQI,4/7/2022 12:59,,Completed,"2,000.00",,"2,008.60"
QD72YLOXXW,4/7/2022 12:01,,Completed,,-55,8.6
QD63XD8RR5,4/6/2022 18:27,,Completed,,-952,63.6
QD67XBDUTV,4/6/2022 18:08,,Completed,"1,000.00",,"1,015.60"
QD64X18QOM,4/6/2022 16:04,,Completed,,-30,15.6
QD54V25SG2,4/5/2022 16:33,,Completed,,-10,45.6
QD54V25SG2,4/5/2022 16:33,,Completed,,-100,55.6
QD51V1MRCD,4/5/2022 16:26,,Completed,,-400,155.6
QD53V1KH2H,4/5/2022 16:25,,Completed,400,,555.6
QD57UITBHR,4/5/2022 12:00,,Completed,,-30,155.6
QD47SZMCVT,4/4/2022 15:57,,Completed,,-23,185.6
QD47SZMCVT,4/4/2022 15:57,,Completed,,-200,208.6
QD44SZK5UQ,4/4/2022 15:56,,Completed,300,,408.6
QD45SY5215,4/4/2022 15:36,,Completed,,-27,108.6
QD45SY5215,4/4/2022 15:36,,Completed,,-500,135.6
QD47SMOKJT,4/4/2022 12:54,,Completed,,-30,635.6
QD34RRO25Y,4/3/2022 20:58,,Completed,,-500,665.6
QD35RQKWN7,4/3/2022 20:43,,Completed,500,,"1,165.60"
QD32RCMYIE,4/3/2022 18:09,,Completed,,-28,665.6
QD32RCMYIE,4/3/2022 18:09,,Completed,,"-1,300.00",693.6
QD33RCC741,4/3/2022 18:05,,Completed,"1,000.00",,"1,993.60"
QD39RC4XMB,4/3/2022 18:03,,Completed,,-65,993.6
QD38RBVC3Y,4/3/2022 18:00,,Completed,,-150,"1,058.60"
QD34R81ER2,4/3/2022 17:08,,Completed,,-100,"1,208.60"
QD37QX0KO9,4/3/2022 14:28,,Completed,"1,200.00",,"1,308.60"
QD30QMLPQK,4/3/2022 11:40,,Completed,,-20,108.6
QD31QIVZ3N,4/3/2022 10:34,,Completed,100,,128.6
QD33QG7D97,4/3/2022 9:47,,Completed,,-27,28.6
QD33QG7D97,4/3/2022 9:47,,Completed,,-150,55.6
QD39QFYECD,4/3/2022 9:42,,Completed,200,,205.6
QD13MRKT91,4/1/2022 13:47,,Completed,,-15,5.6
Statement Verification Code,"To verify the validity of this M-PESA statement dial *334#, select My account and follow theprompts to enter the code.",,,,,
,,,,,,
LLHKTUZR,,,,,,
Receipt No.,Completion Time,,Transaction Status,Paid In,Withdrawn,Balance
QD17MRK3YV,4/1/2022 13:46,,Completed,20,,20.6
QCT3H71OSL,3/29/2022 17:26,,Completed,,-27,0.6
QCT3H71OSL,3/29/2022 17:26,,Completed,,-450,27.6
QCT7H6NP97,3/29/2022 17:21,,Completed,460,,477.6
QCS4F8WWMK,3/28/2022 16:59,,Completed,,-6,17.6
QCS4F8WWMK,3/28/2022 16:59,,Completed,,-200,23.6
QCS5F8V93T,3/28/2022 16:58,,Completed,200,,223.6
QCR9DBY3HV,3/27/2022 16:10,,Completed,,-27,23.6
QCR9DBY3HV,3/27/2022 16:10,,Completed,,-500,50.6
QCQ1BAFPYB,3/26/2022 13:49,,Completed,,-500,0.6
QCQ1BAETS9,3/26/2022 13:49,,Completed,500,,500.6
QCQ9ANXSYL,3/26/2022 7:34,,Completed,,"-5,917.00",0.6
QCQ4ANX40E,3/26/2022 7:33,,Completed,,"-2,999.00","5,917.60"
QCQ5AMWOCZ,3/26/2022 7:02,,Completed,"8,900.00",,"8,916.60"
QCO28BUD5K,3/24/2022 20:13,,Completed,,-10,16.6
QCO08AFU0M,3/24/2022 19:58,,Completed,,-23,26.6
QCO08AFU0M,3/24/2022 19:58,,Completed,,-500,49.6
QCO88A4Q5K,3/24/2022 19:55,,Completed,530,,549.6
QCO988ZVHP,3/24/2022 19:44,,Completed,,-516,19.6
QCO47WJ8L2,3/24/2022 17:33,,Completed,,"-1,500.00",535.6
QCO77WHG0P,3/24/2022 17:33,,Completed,"1,500.00",,"2,035.60"
QCO77LK0RH,3/24/2022 14:54,,Completed,,-35,535.6
QCO678GYJ2,3/24/2022 11:32,,Completed,,-75,570.6
QCO678GYJ2,3/24/2022 11:32,,Completed,,"-7,000.00",645.6
QCO078FA32,3/24/2022 11:31,,Completed,"7,600.00",,"7,645.60"
QCN56232LL,3/23/2022 17:40,,Completed,,-27,45.6
QCN56232LL,3/23/2022 17:40,,Completed,,-500,72.6
QCN9621XW5,3/23/2022 17:40,,Completed,500,,572.6
QCN35XQVQ7,3/23/2022 16:43,,Completed,,-28,72.6
QCN35XQVQ7,3/23/2022 16:43,,Completed,,"-1,600.00",100.6
QCN05XKRP0,3/23/2022 16:40,,Completed,"1,700.00",,"1,700.60"
QCN75VR6HB,3/23/2022 16:13,,Completed,,-30,0.6
QCM54HCS0J,3/22/2022 19:23,,Completed,,-100,30.6
QCM74HAA3N,3/22/2022 19:23,,Completed,100,,130.6
QCM942E99B,3/22/2022 16:28,,Completed,,-6,30.6
QCM942E99B,3/22/2022 16:28,,Completed,,-450,36.6
QCM242CHRU,3/22/2022 16:27,,Completed,450,,486.6
QCM541K343,3/22/2022 16:15,,Completed,,-12,36.6
QCM541K343,3/22/2022 16:15,,Completed,,-800,48.6
QCM741ET09,3/22/2022 16:13,,Completed,830,,848.6
QCM93QZTEH,3/22/2022 13:30,,Completed,,-30,18.6
QCL02654I0,3/21/2022 15:56,,Completed,,-70,48.6
QCL2263S3U,3/21/2022 15:55,,Completed,70,,118.6
QCL123MO3R,3/21/2022 15:17,,Completed,,-10,48.6
Statement Verification Code,"To verify the validity of this M-PESA statement dial *334#, select My account and follow theprompts to enter the code.",,,,,
,,,,,,
LLHKTUZR,,,,,,
Receipt No.,Completion Time,,Transaction Status,Paid In,Withdrawn,Balance
QCL51VQXHR,3/21/2022 13:16,,Completed,,-500,58.6
QCL71VPI43,3/21/2022 13:16,,Completed,500,,558.6
QCJ4YIEZ7Q,3/19/2022 23:45,,Completed,,-2,58.6
QCJ4YIEZ7Q,3/19/2022 23:45,,Completed,,-100,60.6
QCJ8YIE1EM,3/19/2022 23:44,,Completed,100,,160.6
QCJ1YEOPUJ,3/19/2022 21:53,,Completed,,-51,60.6
QCJ1YEOPUJ,3/19/2022 21:53,,Completed,,"-2,900.00",111.6
QCJ1YEM0JR,3/19/2022 21:52,,Completed,100,,"3,011.60"
QCJ9YEL1T5,3/19/2022 21:51,,Completed,"1,500.00",,"2,911.60"
QCJ2YCHSHE,3/19/2022 21:17,,Completed,,-20,"1,411.60"
QCJ4YBR5D4,3/19/2022 21:07,,Completed,,-100,"1,431.60"
QCJ3Y9BZVN,3/19/2022 20:36,,Completed,,-84,"1,531.60"
QCJ3Y9BZVN,3/19/2022 20:36,,Completed,,"-7,000.00","1,615.60"
QCJ8Y98WK0,3/19/2022 20:35,,Completed,,-290,"8,615.60"
QCJ5Y89WS9,3/19/2022 20:24,,Completed,"7,100.00",,"8,905.60"
QCI8VF6ZT2,3/19/2022 17:40,,Completed,"1,800.00",,"1,805.60"
QCJ1X0NEFV,3/19/2022 10:59,,Completed,,-23,5.6
QCJ1X0NEFV,3/19/2022 10:59,,Completed,,-300,28.6
QCJ2X0L9BS,3/19/2022 10:59,,Completed,300,,328.6
QCI5WDPBSB,3/18/2022 20:58,,Completed,,-22,28.6
QCI5WDPBSB,3/18/2022 20:58,,Completed,,"-1,200.00",50.6
QCI0WDOBXM,3/18/2022 20:58,,Completed,"1,250.00",,"1,250.60"
QCI1W0Z2LB,3/18/2022 18:51,,Completed,,-750,0.6
QCI1VY19CT,3/18/2022 18:20,,Completed,550,,750.6
QCI1VW2M5T,3/18/2022 17:58,,Completed,,-80,200.6
QCI9VOUXBF,3/18/2022 16:27,,Completed,,"-1,750.00",280.6
QCI3VIEV4P,3/18/2022 14:53,,Completed,,-35,"2,030.60"
QCI2VI8SXO,3/18/2022 14:50,,Completed,"2,000.00",,"2,065.60"
QCI9VGKK5H,3/18/2022 14:26,,Completed,,-10,65.6
QCI7VEW23F,3/18/2022 14:01,,Completed,,-67,75.6
QCI7VEW23F,3/18/2022 14:01,,Completed,,"-3,800.00",142.6
QCI0VEUUSW,3/18/2022 14:00,,Completed,100,,"3,942.60"
QCI1VES5XZ,3/18/2022 13:59,,Completed,"3,800.00",,"3,842.60"
QCI9VEMZIJ,3/18/2022 13:57,,Completed,,-28,42.6
QCI9VEMZIJ,3/18/2022 13:57,,Completed,,"-1,800.00",70.6
QCI1VEFNSZ,3/18/2022 13:54,,Completed,"1,800.00",,"1,870.60"
QCI0VD2N3S,3/18/2022 13:34,,Completed,,-150,70.6
QCI9VD1WJX,3/18/2022 13:34,,Completed,200,,220.6
QCI9VC1EY7,3/18/2022 13:19,,Completed,,-12,20.6
QCI2VAL1J0,3/18/2022 12:57,,Completed,,-50,32.6
QCI1VAJA2T,3/18/2022 12:56,,Completed,50,,82.6
QCI1UXVHG9,3/18/2022 9:37,,Completed,,-12,32.6
QCI1UXVHG9,3/18/2022 9:37,,Completed,,"-1,000.00",44.6
QCI8UXUALY,3/18/2022 9:36,,Completed,"1,000.00",,"1,044.60"
QCH4U8XVYS,3/17/2022 19:35,,Completed,,-5,44.6
QCH5TPPU2T,3/17/2022 15:47,,Completed,,-10,49.6
Statement Verification Code,"To verify the validity of this M-PESA statement dial *334#, select My account and follow theprompts to enter the code.",,,,,
,,,,,,
LLHKTUZR,,,,,,
Receipt No.,Completion Time,,Transaction Status,Paid In,Withdrawn,Balance
QCH5TPPU2T,3/17/2022 15:47,,Completed,,-100,59.6
QCH0TPLOY2,3/17/2022 15:45,,Completed,,-252,159.6
QCH1TPHLJP,3/17/2022 15:44,,Completed,400,,411.6
QCG2RZVR3Y,3/16/2022 17:26,,Completed,,-32,11.6
QCG2RZVR3Y,3/16/2022 17:26,,Completed,,"-2,000.00",43.6
QCG6RZULTY,3/16/2022 17:25,,Completed,"2,030.00",,"2,043.60"
QCG5RU1GVF,3/16/2022 16:05,,Completed,,"-8,800.00",13.6
QCG1RU0WBB,3/16/2022 16:05,,Completed,"8,800.00",,"8,813.60"
QCG7RQW5ST,3/16/2022 15:17,,Completed,,-49,13.6
QCG2RQVCGK,3/16/2022 15:16,,Completed,50,,62.6
QCF1QMRYXT,3/15/2022 20:53,,Completed,,"-5,100.00",12.6
QCF1QMGZ11,3/15/2022 20:49,,Completed,"5,100.00",,"5,112.60"
QCF1QD766X,3/15/2022 19:18,,Completed,,-30,12.6
QCF1PYHAB9,3/15/2022 16:24,,Completed,,-20,42.6
QCF9PRMDL1,3/15/2022 14:37,,Completed,,-10,62.6
QCF6PIUU12,3/15/2022 12:24,,Completed,,-6,72.6
QCF6PIUU12,3/15/2022 12:24,,Completed,,-450,78.6
QCF4PITZVQ,3/15/2022 12:24,,Completed,500,,528.6
QCF4P69USG,3/15/2022 9:01,,Completed,,-30,28.6
QCF6P4MZPK,3/15/2022 8:32,,Completed,30,,58.6
QCE7O9DICB,3/14/2022 17:47,,Completed,,-23,28.6
QCE7O9DICB,3/14/2022 17:47,,Completed,,-300,51.6
QCE6O9AZT4,3/14/2022 17:46,,Completed,50,,351.6
QCE8O997AY,3/14/2022 17:45,,Completed,300,,301.6
QCE2N9R9CW,3/14/2022 8:53,,Completed,,"-3,000.00",1.6
QCE0N9PW92,3/14/2022 8:53,,Completed,"3,000.00",,"3,001.60"
QCE7N9PION,3/14/2022 8:52,,Completed,,-97,1.6
QCE7N9PION,3/14/2022 8:52,,Completed,,"-11,600.00",98.6
QCE0N9OJVE,3/14/2022 8:52,,Completed,"11,600.00",,"11,698.60"
QCD7N1VBVF,3/13/2022 23:39,,Completed,,-6,98.6
QCD7N1VBVF,3/13/2022 23:39,,Completed,,-500,104.6
QCD2N1UYZE,3/13/2022 23:39,,Completed,500,,604.6
QCD0MEFVD0,3/13/2022 17:41,,Completed,,-32,104.6
QCD0MEFVD0,3/13/2022 17:41,,Completed,,"-1,600.00",136.6
QCD6MEDCX2,3/13/2022 17:40,,Completed,"1,650.00",,"1,736.60"
QCD2LV7ZBC,3/13/2022 12:48,,Completed,0,,86.6
QCC7KF50KR,3/12/2022 16:36,,Completed,,-23,86.6
QCC7KF50KR,3/12/2022 16:36,,Completed,,-200,109.6
QCC8KF3QKY,3/12/2022 16:35,,Completed,250,,309.6
QCB1IRCYIH,3/11/2022 18:52,,Completed,,-12,59.6
QCB1IRCYIH,3/11/2022 18:52,,Completed,,"-1,000.00",71.6
QCB3IR5887,3/11/2022 18:50,,Completed,"1,050.00",,"1,071.60"
QCB6INSVZG,3/11/2022 18:14,,Completed,,-75,21.6
QCB6INSVZG,3/11/2022 18:14,,Completed,,"-7,000.00",96.6
Statement Verification Code,"To verify the validity of this M-PESA statement dial *334#, select My account and follow theprompts to enter the code.",,,,,
,,,,,,
LLHKTUZR,,,,,,
Receipt No.,Completion Time,,Transaction Status,Paid In,Withdrawn,Balance
QCB0INPL3A,3/11/2022 18:13,,Completed,"2,000.00",,"7,096.60"
QCB4IBCO9U,3/11/2022 15:30,,Completed,,"-2,000.00","5,096.60"
QCB1I7MJF5,3/11/2022 14:34,,Completed,,-30,"7,096.60"
QCA5GYOIQR,3/10/2022 19:48,,Completed,,-32,"7,126.60"
QCA5GYOIQR,3/10/2022 19:48,,Completed,,"-2,000.00","7,158.60"
QCA0GCSHKM,3/10/2022 15:32,,Completed,,"-30,000.00","9,158.60"
QCA3GCNJ67,3/10/2022 15:30,,Completed,"29,500.00",,"39,158.60"
QCA0GC5EL2,3/10/2022 15:23,,Completed,,-50,"9,658.60"
QCA6G3RSFC,3/10/2022 13:19,,Completed,,-35,"9,708.60"
QCA1FWI9TX,3/10/2022 11:31,,Completed,"9,250.00",,"9,743.60"
QC91EG5XF3,3/9/2022 15:55,,Completed,,-70,493.6
QC96EFCKRI,3/9/2022 15:43,,Completed,,-10,563.6
QC88CUA78Q,3/8/2022 18:35,,Completed,,-23,573.6
QC88CUA78Q,3/8/2022 18:35,,Completed,,-300,596.6
QC87CRXFHN,3/8/2022 18:10,,Completed,,-10,896.6
QC80CQEIF0,3/8/2022 17:52,,Completed,,-50,906.6
QC84CNOXY8,3/8/2022 17:19,,Completed,,-80,956.6
QC82CN98GE,3/8/2022 17:13,,Completed,,-10,"1,036.60"
QC85CM8AQH,3/8/2022 17:00,,Completed,500,,"1,046.60"
QC80CL70EG,3/8/2022 16:46,,Completed,,"-1,940.00",546.6
QC85CKTPEP,3/8/2022 16:41,,Completed,"1,000.00",,"2,486.60"
QC87CKJ07J,3/8/2022 16:37,,Completed,,-20,"1,486.60"
QC86CG3TEM,3/8/2022 15:32,,Completed,,-50,"1,506.60"
QC84CFSKM2,3/8/2022 15:27,,Completed,"1,500.00",,"1,556.60"
QC87CFMPMV,3/8/2022 15:24,,Completed,,-10,56.6
QC87CF38B3,3/8/2022 15:16,,Completed,,-20,66.6
QC79B0ELZN,3/7/2022 19:21,,Completed,,-112,86.6
QC79B0ELZN,3/7/2022 19:21,,Completed,,"-30,000.00",198.6
QC77B0AT11,3/7/2022 19:20,,Completed,150,,"30,198.60"
QC75AYGX4D,3/7/2022 19:03,,Completed,"30,000.00",,"30,048.60"
QC769S6GPM,3/7/2022 9:23,,Completed,,-5,48.6
QC657RZIRB,3/6/2022 7:49,,Completed,,-12,53.6
QC657RZIRB,3/6/2022 7:49,,Completed,,"-1,000.00",65.6
QC697RPH6R,3/6/2022 7:42,,Completed,"1,000.00",,"1,065.60"
QC5970JBED,3/5/2022 18:35,,Completed,,-28,65.6
QC5970JBED,3/5/2022 18:35,,Completed,,"-1,300.00",93.6
QC586ZTJF4,3/5/2022 18:28,,Completed,"1,000.00",,"1,393.60"
QC566PHAE4,3/5/2022 16:25,,Completed,0,,393.6
QC536P4AHV,3/5/2022 16:21,,Completed,,-6,393.6
Statement Verification Code,"To verify the validity of this M-PESA statement dial *334#, select My account and follow theprompts to enter the code.",,,,,
,,,,,,
LLHKTUZR,,,,,,
Receipt No.,Completion Time,,Transaction Status,Paid In,Withdrawn,Balance
QC536P4AHV,3/5/2022 16:21,,Completed,,-500,399.6
QC566P30QQ,3/5/2022 16:20,,Completed,500,,899.6
QC506EY5NI,3/5/2022 14:02,,Completed,,"-7,500.00",399.6
QC516EW8C9,3/5/2022 14:01,,Completed,"7,500.00",,"7,899.60"
QC546CEW46,3/5/2022 13:28,,Completed,,-10,399.6
QC5765TAF7,3/5/2022 11:56,,Completed,,-27,409.6
QC5765TAF7,3/5/2022 11:56,,Completed,,-500,436.6
QC51650PGJ,3/5/2022 11:44,,Completed,,-500,936.6
QC424U61GU,3/4/2022 18:00,,Completed,0,,"1,436.60"
QC464N5496,3/4/2022 16:36,,Completed,,-30,"1,436.60"
QC454KPCO5,3/4/2022 16:03,,Completed,,-50,"1,466.60"
QC404K6W30,3/4/2022 15:56,,Completed,,"-1,381.00","1,516.60"
QC424GBE0W,3/4/2022 15:02,,Completed,,-84,"2,897.60"
QC424GBE0W,3/4/2022 15:02,,Completed,,"-5,100.00","2,981.60"
QC464G4WKA,3/4/2022 15:00,,Completed,,-100,"8,081.60"
QC464G4WJG,3/4/2022 15:00,,Completed,"5,000.00",,"8,181.60"
QC404ELB96,3/4/2022 14:38,,Completed,,-10,"3,181.60"
QC454E6EU7,3/4/2022 14:32,,Completed,"2,050.00",,"3,191.60"
QC444595P6,3/4/2022 12:28,,Completed,0,,"1,141.60"
QC473KZE91,3/4/2022 6:48,,Completed,,-70,"1,141.60"
QC382KA8TY,3/3/2022 16:23,,Completed,,-80,"1,211.60"
QC372HVMR3,3/3/2022 15:49,,Completed,,-900,"1,291.60"
QC311IDB67,3/3/2022 6:37,,Completed,,-35,"2,191.60"
QC11XN0JFL,3/1/2022 17:53,,Completed,,-27,"2,226.60"
QC11XN0JFL,3/1/2022 17:53,,Completed,,-500,"2,253.60"
QC19XMODVV,3/1/2022 17:49,,Completed,,-130,"2,753.60"
QC14XL1K4K,3/1/2022 17:30,,Completed,,-272,"2,883.60"
QC15X9PJUT,3/1/2022 14:54,,Completed,,-30,"3,155.60"
QC16WGBPWU,3/1/2022 7:01,,Completed,,-6,"3,185.60"
QC16WGBPWU,3/1/2022 7:01,,Completed,,-420,"3,191.60"
QBS6VIQW4A,2/28/2022 17:08,,Completed,,-6,"3,611.60"
QBS6VIQW4A,2/28/2022 17:08,,Completed,,-150,"3,617.60"
QBS3VCIDKJ,2/28/2022 15:41,,Completed,,-27,"3,767.60"
QBS3VCIDKJ,2/28/2022 15:41,,Completed,,-500,"3,794.60"
QBS0UO3JFO,2/28/2022 9:30,,Completed,,-80,"4,294.60"
QBS4UNMMMA,2/28/2022 9:22,,Completed,30,,"4,374.60"
QBS1UGHIBT,2/28/2022 6:48,,Completed,,-60,"4,344.60"
QBS0UF8TLM,2/28/2022 5:02,,Completed,,-12,"4,404.60"
QBS0UF8TLM,2/28/2022 5:02,,Completed,,-900,"4,416.60"
Statement Verification Code,"To verify the validity of this M-PESA statement dial *334#, select My account and follow theprompts to enter the code.",,,,,
,,,,,,
LLHKTUZR,,,,,,
Receipt No.,Completion Time,,Transaction Status,Paid In,Withdrawn,Balance
QBR5U77XH1,2/27/2022 21:02,,Completed,,-2,"5,316.60"
QBR5U77XH1,2/27/2022 21:02,,Completed,,-100,"5,318.60"
QBR2TDEGZA,2/27/2022 14:28,,Completed,,-34,"5,418.60"
QBR2TDEGZA,2/27/2022 14:28,,Completed,,"-1,000.00","5,452.60"
QBR6TD8UJM,2/27/2022 14:26,,Completed,"1,000.00",,"6,452.60"
QBR6TD7E1W,2/27/2022 14:25,,Completed,,-75,"5,452.60"
QBR6TD7E1W,2/27/2022 14:25,,Completed,,"-7,200.00","5,527.60"
QBR9TCPICN,2/27/2022 14:17,,Completed,,-112,"12,727.60"
QBR9TCPICN,2/27/2022 14:17,,Completed,,"-8,200.00","12,839.60"
QBR8TCKJWG,2/27/2022 14:15,,Completed,,-100,"21,039.60"
QBR8TC1HFO,2/27/2022 14:07,,Completed,,"-2,812.00","21,139.60"
QBR8TADHX6,2/27/2022 13:40,,Completed,,-200,"23,951.60"
QBR8T9IC28,2/27/2022 13:26,,Completed,"24,000.00",,"24,151.60"
QBR3T1RS0D,2/27/2022 11:05,,Completed,,-30,151.6
QBR9T1MFWP,2/27/2022 11:02,,Completed,,-23,181.6
QBR9T1MFWP,2/27/2022 11:02,,Completed,,-300,204.6
QBR6SWGFLE,2/27/2022 9:24,,Completed,,-12,504.6
QBR6SWGFLE,2/27/2022 9:24,,Completed,,"-1,000.00",516.6
QBR4SWFAW2,2/27/2022 9:24,,Completed,"1,000.00",,"1,516.60"
QBP8PQBPBA,2/25/2022 15:12,,Completed,,-35,516.6
QBP7PP75PP,2/25/2022 14:55,,Completed,,-27,551.6
QBP7PP75PP,2/25/2022 14:55,,Completed,,-500,578.6
QBP1P3KW0V,2/25/2022 9:01,,Completed,,-30,"1,078.60"
QBO4OCVA3O,2/24/2022 18:51,,Completed,,-22,"1,108.60"
QBO4OCVA3O,2/24/2022 18:51,,Completed,,"-1,200.00","1,130.60"
QBN9MWVJEB,2/23/2022 20:58,,Completed,,-55,"2,330.60"
QBN9MWVJEB,2/23/2022 20:58,,Completed,,"-5,000.00","2,385.60"
QBN7MW4U59,2/23/2022 20:47,,Completed,,-30,"7,385.60"
QBN8MJABLK,2/23/2022 18:29,,Completed,,"-2,000.00","7,415.60"
QBN6MJ8E26,2/23/2022 18:28,,Completed,100,,"9,415.60"
QBN3MJ4HMJ,2/23/2022 18:27,,Completed,,"-10,000.00","9,315.60"
QBN7MIW3WF,2/23/2022 18:24,,Completed,,"-2,999.00","19,315.60"
QBN0MI9XO4,2/23/2022 18:17,,Completed,100,,"22,314.60"
QBN6MI5T9S,2/23/2022 18:16,,Completed,50,,"22,214.60"
QBN4MI57NE,2/23/2022 18:16,,Completed,100,,"22,164.60"
QBN5MHKKQF,2/23/2022 18:09,,Completed,,-6,"22,064.60"
QBN5MHKKQF,2/23/2022 18:09,,Completed,,-250,"22,070.60"
QBN1MELD8N,2/23/2022 17:33,,Completed,"18,900.00",,"22,320.60"
QBN8M223JK,2/23/2022 14:20,,Completed,,-180,"3,420.60"
QBM3KN7G9X,2/22/2022 17:37,,Completed,,-100,"3,600.60"
Statement Verification Code,"To verify the validity of this M-PESA statement dial *334#, select My account and follow theprompts to enter the code.",,,,,
,,,,,,
LLHKTUZR,,,,,,
Receipt No.,Completion Time,,Transaction Status,Paid In,Withdrawn,Balance
QBM7KLCYGJ,2/22/2022 17:12,,Completed,,"-1,200.00","3,700.60"
QBM5KHQOSZ,2/22/2022 16:19,,Completed,,-22,"4,900.60"
QBM5KHQOSZ,2/22/2022 16:19,,Completed,,"-1,500.00","4,922.60"
QBM0KHJUZO,2/22/2022 16:16,,Completed,,-30,"6,422.60"
QBM3KDOOMF,2/22/2022 15:12,,Completed,,-35,"6,452.60"
QBM3JMX79D,2/22/2022 7:09,,Completed,,-6,"6,487.60"
QBM3JMX79D,2/22/2022 7:09,,Completed,,-500,"6,493.60"
QBM4JLT55A,2/22/2022 6:15,,Completed,,-23,"6,993.60"
QBM4JLT55A,2/22/2022 6:15,,Completed,,-200,"7,016.60"
QBL8J6748E,2/21/2022 19:32,,Completed,,-55,"7,216.60"
QBL8J6748E,2/21/2022 19:32,,Completed,,"-4,300.00","7,271.60"
QBL3IRY0JF,2/21/2022 16:47,,Completed,,"-3,500.00","11,571.60"
QBL1IOBXZ5,2/21/2022 15:52,,Completed,,-10,"15,071.60"
QBL7IKV8IH,2/21/2022 14:55,,Completed,"15,000.00",,"15,081.60"
QBL4IKS436,2/21/2022 14:54,,Completed,,-30,81.6
QBL9I1GR07,2/21/2022 9:33,,Completed,,-6,111.6
QBL9I1GR07,2/21/2022 9:33,,Completed,,-250,117.6
QBL0I1D66Q,2/21/2022 9:32,,Completed,200,,367.6
QBK0HAQICC,2/20/2022 18:46,,Completed,,-20,167.6
QBJ3EZ5QHV,2/19/2022 13:59,,Completed,,-30,187.6
QBJ0EYAQ1K,2/19/2022 13:46,,Completed,200,,217.6
QBJ9ELWLYR,2/19/2022 10:35,,Completed,,-12,17.6
QBJ9ELWLYR,2/19/2022 10:35,,Completed,,"-1,000.00",29.6
QBJ8ELW3QW,2/19/2022 10:34,,Completed,"1,000.00",,"1,029.60"
QBI7E1VSH1,2/18/2022 21:02,,Completed,,-22,29.6
QBI7E1VSH1,2/18/2022 21:02,,Completed,,"-1,200.00",51.6
QBI2E1UKLQ,2/18/2022 21:02,,Completed,100,,"1,251.60"
QBI5E1TAAV,2/18/2022 21:01,,Completed,"1,100.00",,"1,151.60"
QBI2DGKDLO,2/18/2022 17:04,,Completed,,-80,51.6
QBI6DF3HFI,2/18/2022 16:44,,Completed,,-267,131.6
QBI7CLSPVP,2/18/2022 8:48,,Completed,,-40,398.6
QBI6CHWRV2,2/18/2022 7:20,,Completed,,-40,438.6
QBI3CH1WJH,2/18/2022 6:49,,Completed,,-50,478.6
QBI5CG18GH,2/18/2022 5:33,,Completed,,-35,28.6
QBH8C18TAS,2/17/2022 19:51,,Completed,0,,63.6
QBH4BJKZJ0,2/17/2022 16:28,,Completed,,-80,63.6
QBH5ANUZ43,2/17/2022 7:31,,Completed,,-40,143.6
QBH1AMI2QX,2/17/2022 6:47,,Completed,,-70,183.6
QBH6AM07R0,2/17/2022 6:21,,Completed,0,,253.6
QBH4ALZLPW,2/17/2022 6:20,,Completed,200,,253.6
QBG19P6CZ9,2/16/2022 16:30,,Completed,,-80,53.6
QBG19NWJ6H,2/16/2022 16:11,,Completed,100,,133.6
Statement Verification Code,"To verify the validity of this M-PESA statement dial *334#, select My account and follow theprompts to enter the code.",,,,,
,,,,,,
LLHKTUZR,,,,,,
Receipt No.,Completion Time,,Transaction Status,Paid In,Withdrawn,Balance
QBG28S9J7G,2/16/2022 6:38,,Completed,,-50,33.6
QBF58J22BN,2/15/2022 20:58,,Completed,,-2,83.6
QBF58J22BN,2/15/2022 20:58,,Completed,,-100,85.6
QBF37R60AX,2/15/2022 15:24,,Completed,,-27,185.6
QBF37R60AX,2/15/2022 15:24,,Completed,,-200,212.6
QBF47QE8G8,2/15/2022 15:11,,Completed,300,,412.6
QBF57QAVL5,2/15/2022 15:10,,Completed,,-30,112.6
QBF87MWORQ,2/15/2022 14:14,,Completed,,-6,142.6
QBF87MWORQ,2/15/2022 14:14,,Completed,,-230,148.6
QBF87LKICK,2/15/2022 13:53,,Completed,,-35,378.6
QBF07L69IO,2/15/2022 13:47,,Completed,,-6,413.6
QBF07L69IO,2/15/2022 13:47,,Completed,,-180,419.6
QBF37KZDLH,2/15/2022 13:44,,Completed,500,,599.6
QBF36YRQ5Z,2/15/2022 6:50,,Completed,,-50,99.6
QBE56FLTVD,2/14/2022 19:13,,Completed,0,,149.6
QBE7628ULP,2/14/2022 16:33,,Completed,,-10,149.6
QBE95YR887,2/14/2022 15:40,,Completed,,-80,159.6
QBE953X58F,2/14/2022 6:39,,Completed,,-80,239.6
QBD43KJ1BA,2/13/2022 9:06,,Completed,,-5,319.6
QBC22O1MI0,2/12/2022 17:44,,Completed,,-10,324.6
QBC52N6MOD,2/12/2022 17:34,,Completed,,-30,334.6
QBC62MWOKQ,2/12/2022 17:30,,Completed,,-5,364.6
QBC62MNKSG,2/12/2022 17:27,,Completed,,-6,369.6
QBC62MNKSG,2/12/2022 17:27,,Completed,,-200,375.6
QBC22DDFPY,2/12/2022 15:15,,Completed,,-35,575.6
QBB513G14Z,2/11/2022 19:44,,Completed,,-12,610.6
QBB513G14Z,2/11/2022 19:44,,Completed,,"-1,000.00",622.6
QBB2ZM2562,2/11/2022 16:26,,Completed,"1,000.00",,"1,622.60"
QBB2ZJZCT2,2/11/2022 15:55,,Completed,,-70,622.6
QBB5ZFU31L,2/11/2022 14:51,,Completed,,-30,692.6
QBA3XC56RP,2/10/2022 12:35,,Completed,,"-4,250.00",722.6
QB90VVRR4U,2/9/2022 16:22,,Completed,,-30,"4,972.60"
QB99VVL231,2/9/2022 16:20,,Completed,,-5,"5,002.60"
QB90VIORS2,2/9/2022 12:59,,Completed,"5,000.00",,"5,007.60"
QB74SPQZQ4,2/7/2022 19:46,,Completed,,"-6,875.00",7.6
QB70SP1NSA,2/7/2022 19:39,,Completed,,-30,"6,882.60"
QB79SMLT9F,2/7/2022 19:16,,Completed,"6,875.00",,"6,912.60"
QB62QL2TTA,2/6/2022 17:48,,Completed,,-6,37.6
QB62QL2TTA,2/6/2022 17:48,,Completed,,-170,43.6
QB60QFT4KQ,2/6/2022 16:33,,Completed,,-260,213.6
Statement Verification Code,"To verify the validity of this M-PESA statement dial *334#, select My account and follow theprompts to enter the code.",,,,,
,,,,,,
LLHKTUZR,,,,,,
Receipt No.,Completion Time,,Transaction Status,Paid In,Withdrawn,Balance
QB69QFDDDT,2/6/2022 16:27,,Completed,,-400,473.6
QB63QF20KF,2/6/2022 16:22,,Completed,300,,873.6
QB66QF0IFC,2/6/2022 16:21,,Completed,500,,573.6
QB69QEYQ4F,2/6/2022 16:20,,Completed,,-5,73.6
QB64QC7ROS,2/6/2022 15:38,,Completed,,-30,78.6
QB53O8C09P,2/5/2022 12:56,,Completed,,"-1,300.00",108.6
QB50O876QE,2/5/2022 12:54,,Completed,"1,300.00",,"1,408.60"
QB52O872TM,2/5/2022 12:54,,Completed,,"-1,300.00",108.6
QB50O84FT0,2/5/2022 12:52,,Completed,"1,300.00",,"1,408.60"
QB50O84FRC,2/5/2022 12:52,,Completed,,"-1,300.00",108.6
QB57O7JOEJ,2/5/2022 12:44,,Completed,"1,300.00",,"1,408.60"
QB58NQXDNK,2/5/2022 8:13,,Completed,,-5,108.6
QB52NQUM0G,2/5/2022 8:11,,Completed,,-30,113.6
QB56NQK98U,2/5/2022 8:05,,Completed,,-23,143.6
QB56NQK98U,2/5/2022 8:05,,Completed,,-400,166.6
QB52NPYK2I,2/5/2022 7:52,,Completed,500,,566.6
QB43LSTM3F,2/4/2022 7:29,,Completed,,-40,66.6
QB48LRUNAC,2/4/2022 6:58,,Completed,,-80,106.6
QB31KXR0BP,2/3/2022 17:15,,Completed,,-100,186.6
QB30KUTKEW,2/3/2022 16:34,,Completed,,-80,286.6
QB37KU0HAF,2/3/2022 16:22,,Completed,,-35,366.6
QB35K5FVU9,2/3/2022 9:49,,Completed,,-40,401.6
QB29JM5LKH,2/2/2022 20:36,,Completed,,-2,441.6
QB29JM5LKH,2/2/2022 20:36,,Completed,,-100,443.6
QB20J19TKM,2/2/2022 16:46,,Completed,,-988,543.6
QB28J0X6NW,2/2/2022 16:41,,Completed,"1,000.00",,"1,531.60"
QB14G985TC,2/1/2022 7:08,,Completed,,-35,531.6
QAV9G3I7DH,1/31/2022 22:10,,Completed,500,,566.6
QAV1F8GUK7,1/31/2022 15:36,,Completed,,-30,66.6
QAV2F8EA8M,1/31/2022 15:35,,Completed,,-6,96.6
QAV2F8EA8M,1/31/2022 15:35,,Completed,,-200,102.6
QAV9F8DRH9,1/31/2022 15:34,,Completed,250,,302.6
QAT9C4BECV,1/29/2022 18:09,,Completed,,-100,52.6
QAT0C44W0S,1/29/2022 18:07,,Completed,100,,152.6
QAT4C0MRKI,1/29/2022 17:23,,Completed,,-12,52.6
QAT4C0MRKI,1/29/2022 17:23,,Completed,,-650,64.6
QAT3C0IVJD,1/29/2022 17:22,,Completed,700,,714.6
QAT3BBLYM9,1/29/2022 10:57,,Completed,,-32,14.6
QAT0BB8GAE,1/29/2022 10:51,,Completed,,-6,46.6
QAT0BB8GAE,1/29/2022 10:51,,Completed,,-200,52.6
QAT2BB76IO,1/29/2022 10:50,,Completed,250,,252.6
QAS6A1YECK,1/28/2022 16:06,,Completed,,-80,2.6
QAS29JBH6U,1/28/2022 11:00,,Completed,,"-2,999.00",82.6
Statement Verification Code,"To verify the validity of this M-PESA statement dial *334#, select My account and follow theprompts to enter the code.",,,,,
,,,,,,
LLHKTUZR,,,,,,
Receipt No.,Completion Time,,Transaction Status,Paid In,Withdrawn,Balance
QAS99J6R5D,1/28/2022 10:58,,Completed,"3,000.00",,"3,081.60"
QAS39J4O25,1/28/2022 10:57,,Completed,,-5,81.6
QAS397QV7X,1/28/2022 7:10,,Completed,,-80,86.6
QAR18SCAGR,1/27/2022 19:47,,Completed,,-30,166.6
QAR282W1V8,1/27/2022 13:51,,Completed,,-150,196.6
QAR282TJXQ,1/27/2022 13:50,,Completed,200,,346.6
QAQ973R5C5,1/26/2022 20:04,,Completed,,-102,146.6
QAQ973R5C5,1/26/2022 20:04,,Completed,,"-20,000.00",248.6
QAQ373PQDT,1/26/2022 20:04,,Completed,200,,"20,248.60"
QAQ273L380,1/26/2022 20:03,,Completed,"20,000.00",,"20,048.60"
QAQ46USLF4,1/26/2022 18:33,,Completed,,-70,48.6
QAQ86UPTB2,1/26/2022 18:33,,Completed,50,,118.6
QAQ86PQTXY,1/26/2022 17:30,,Completed,,-80,68.6
QAQ96P5D4V,1/26/2022 17:22,,Completed,,-12,148.6
QAQ96P5D4V,1/26/2022 17:22,,Completed,,"-1,000.00",160.6
QAQ06P3S4Y,1/26/2022 17:21,,Completed,"1,100.00",,"1,160.60"
QAQ66I8LJY,1/26/2022 15:32,,Completed,,-23,60.6
QAQ66I8LJY,1/26/2022 15:32,,Completed,,-500,83.6
QAQ96EESTX,1/26/2022 14:26,,Completed,,-12,583.6
QAQ96EESTX,1/26/2022 14:26,,Completed,,"-1,000.00",595.6
QAQ66ED6QQ,1/26/2022 14:26,,Completed,"1,500.00",,"1,595.60"
QAQ16CLX8V,1/26/2022 13:56,,Completed,,-100,95.6
QAQ85S0XLQ,1/26/2022 7:35,,Completed,,-40,195.6
QAQ25R17T8,1/26/2022 7:03,,Completed,,-60,235.6
QAP95CPLGZ,1/25/2022 19:52,,Completed,,-6,295.6
QAP95CPLGZ,1/25/2022 19:52,,Completed,,-400,301.6
QAP45B3K0A,1/25/2022 19:36,,Completed,,-12,701.6
QAP45B3K0A,1/25/2022 19:36,,Completed,,"-1,000.00",713.6
QAP45B0YN6,1/25/2022 19:36,,Completed,"1,000.00",,"1,713.60"
QAP551HE3F,1/25/2022 17:49,,Completed,,-400,713.6
QAP750FDX1,1/25/2022 17:34,,Completed,"1,000.00",,"1,113.60"
QAP94OHQWL,1/25/2022 14:18,,Completed,,-15,113.6
QAP54NLEKN,1/25/2022 14:03,,Completed,,-150,128.6
QAP54NJR7P,1/25/2022 14:02,,Completed,150,,278.6
QAP04D6U5W,1/25/2022 11:04,,Completed,,-12,128.6
QAP04D6U5W,1/25/2022 11:04,,Completed,,"-1,000.00",140.6
QAP947H3UD,1/25/2022 9:20,,Completed,,-20,"1,140.60"
QAO73TM6GL,1/24/2022 21:03,,Completed,,-100,"1,160.60"
QAO42UZOI0,1/24/2022 12:57,,Completed,,-30,"1,260.60"
QAN82AFDLM,1/23/2022 23:39,,Completed,,-55,"1,290.60"
QAN82AFDLM,1/23/2022 23:39,,Completed,,"-5,000.00","1,345.60"
QAN82AEYTY,1/23/2022 23:38,,Completed,"5,000.00",,"6,345.60"
QAN71V30EN,1/23/2022 18:57,,Completed,,-61,"1,345.60"
Statement Verification Code,"To verify the validity of this M-PESA statement dial *334#, select My account and follow theprompts to enter the code.",,,,,
,,,,,,
LLHKTUZR,,,,,,
Receipt No.,Completion Time,,Transaction Status,Paid In,Withdrawn,Balance
QAN21UOCP0,1/23/2022 18:52,,Completed,,-739,"1,406.60"
QAN11TV9E7,1/23/2022 18:42,,Completed,,-20,"2,145.60"
QAN610ZNTS,1/23/2022 10:15,,Completed,,-35,"2,165.60"
QAN410V7ZU,1/23/2022 10:13,,Completed,,-30,"2,200.60"
QAN9ZZT3LV,1/23/2022 9:50,,Completed,,-30,"2,230.60"
QAM2ZA8522,1/22/2022 19:05,,Completed,,"-1,172.00","2,260.60"
QAM5Z59CVN,1/22/2022 18:06,,Completed,,-210,"3,432.60"
QAM5Z59CVN,1/22/2022 18:06,,Completed,,"-65,500.00","3,642.60"
QAM6Z5722K,1/22/2022 18:05,,Completed,"65,500.00",,"69,142.60"
QAM3Z54BYJ,1/22/2022 18:04,,Completed,,-27,"3,642.60"
QAM3Z54BYJ,1/22/2022 18:04,,Completed,,-500,"3,669.60"
QAM2YXN0CA,1/22/2022 16:27,,Completed,840,,"4,169.60"
QAM9YWZZ2L,1/22/2022 16:17,,Completed,,"-1,590.00","3,329.60"
QAM9YWP4L3,1/22/2022 16:13,,Completed,,-5,"4,919.60"
QAM9YS461L,1/22/2022 15:01,,Completed,,-55,"4,924.60"
QAM9YS461L,1/22/2022 15:01,,Completed,,"-5,000.00","4,979.60"
QAM9YLIUPL,1/22/2022 13:17,,Completed,,-1.5,"9,979.60"
QAM9YLIUPL,1/22/2022 13:17,,Completed,,-300,"9,981.10"
QAM3YKBPPX,1/22/2022 12:58,,Completed,,-35,"10,281.10"
QAL5XD575H,1/21/2022 17:52,,Completed,,-80,"10,316.10"
QAL5X972T5,1/21/2022 17:00,,Completed,,-12,"10,396.10"
QAL5X972T5,1/21/2022 17:00,,Completed,,"-1,000.00","10,408.10"
QAL6X6CQDQ,1/21/2022 16:18,,Completed,,-6,"11,408.10"
QAL6X6CQDQ,1/21/2022 16:18,,Completed,,-200,"11,414.10"
QAL1X65PST,1/21/2022 16:15,,Completed,,-30,"11,614.10"
QAL1WDA66T,1/21/2022 7:29,,Completed,,-40,"11,644.10"
QAL2WCGCNW,1/21/2022 6:59,,Completed,,-60,"11,684.10"
QAK4VL0QM4,1/20/2022 17:22,,Completed,,-100,"11,744.10"
QAK5V6LTQH,1/20/2022 13:25,,Completed,,-30,"11,844.10"
QAK6UZRMAM,1/20/2022 11:26,,Completed,,-500,"11,874.10"
QAJ4TY6HA8,1/19/2022 17:46,,Completed,,-10,"12,374.10"
QAJ0TSLIRW,1/19/2022 16:28,,Completed,,-10,"12,384.10"
QAI4S6RYZ4,1/18/2022 16:55,,Completed,,-300,"12,394.10"
QAI3S5FI6B,1/18/2022 16:34,,Completed,,-20,"12,694.10"
QAH7QMCPCP,1/17/2022 17:23,,Completed,,"-1,185.00","12,714.10"
QAH3POMO4T,1/17/2022 7:00,,Completed,,-35,"13,899.10"
QAH0POJJHG,1/17/2022 6:57,,Completed,,-30,"13,934.10"
QAG9P3GYMJ,1/16/2022 18:08,,Completed,,-6,"13,964.10"
QAG9P3GYMJ,1/16/2022 18:08,,Completed,,-500,"13,970.10"
QAG6OZFQGA,1/16/2022 17:10,,Completed,,-10,"14,470.10"
QAF0O24EZ6,1/15/2022 23:29,,Completed,,-35,"14,480.10"
QAF8MTP6GU,1/15/2022 12:16,,Completed,,-2,"14,515.10"
Statement Verification Code,"To verify the validity of this M-PESA statement dial *334#, select My account and follow theprompts to enter the code.",,,,,
,,,,,,
LLHKTUZR,,,,,,
Receipt No.,Completion Time,,Transaction Status,Paid In,Withdrawn,Balance
QAF8MTP6GU,1/15/2022 12:16,,Completed,,-100,"14,517.10"
QAF3MJ0CPP,1/15/2022 9:10,,Completed,,-30,"14,617.10"
QAF7MIRYU1,1/15/2022 9:05,,Completed,,-5,"14,647.10"
QAD1JMWMDN,1/13/2022 14:44,,Completed,,-6,"14,652.10"
QAD1JMWMDN,1/13/2022 14:44,,Completed,,-120,"14,658.10"
QAD3JMCGK9,1/13/2022 14:34,,Completed,,-30,"14,778.10"
QAD5JDGLN3,1/13/2022 11:58,,Completed,,-105,"14,808.10"
QAD5JDGLN3,1/13/2022 11:58,,Completed,,"-50,200.00","14,913.10"
QAD9JDETLN,1/13/2022 11:57,,Completed,,-12,"65,113.10"
QAD9JDETLN,1/13/2022 11:57,,Completed,,-600,"65,125.10"
QAD9J8ZOLH,1/13/2022 10:38,,Completed,,-55,"65,725.10"
QAD9J8ZOLH,1/13/2022 10:38,,Completed,,"-4,300.00","65,780.10"
QAC7IEYPYR,1/12/2022 18:46,,Completed,,-20,"70,080.10"
QAC2HZ0QEU,1/12/2022 14:40,,Completed,,-105,"70,100.10"
QAC2HZ0QEU,1/12/2022 14:40,,Completed,,"-150,000.00","70,205.10"
QAC2HYQW12,1/12/2022 14:35,,Completed,"36,000.00",,"220,205.10"
QAC3HYPCCN,1/12/2022 14:34,,Completed,,"-100,000.00","184,205.10"
QAC4HVRKG8,1/12/2022 13:43,,Completed,,-30,"284,205.10"
QAC7HOCA13,1/12/2022 11:31,,Completed,,-5,"284,235.10"
QAC3HL1BZN,1/12/2022 10:31,,Completed,,-35,"284,240.10"
QAB8GZN57M,1/11/2022 20:08,,Completed,,-23,"284,275.10"
QAB8GZN57M,1/11/2022 20:08,,Completed,,-800,"284,298.10"
QAB3GUORL5,1/11/2022 19:15,,Completed,,-6,"285,098.10"
QAB3GUORL5,1/11/2022 19:15,,Completed,,-500,"285,104.10"
QAB5GTHVBB,1/11/2022 19:02,,Completed,"134,750.00",,"285,604.10"
QAB4GT84DY,1/11/2022 18:59,,Completed,"150,000.00",,"150,854.10"
QAB4G3ZBAE,1/11/2022 12:14,,Completed,,-30,854.1
QAB3FYEZ41,1/11/2022 10:37,,Completed,,-50,884.1
QAB8FW3B34,1/11/2022 9:55,,Completed,,-12,934.1
QAB8FW3B34,1/11/2022 9:55,,Completed,,"-1,000.00",946.1
QAA8F6UI18,1/10/2022 19:12,,Completed,,-87,"1,946.10"
QAA8F6UI18,1/10/2022 19:12,,Completed,,"-8,000.00","2,033.10"
QAA1EYMFBF,1/10/2022 17:34,,Completed,"10,000.00",,"10,033.10"
Statement Verification Code,"To verify the validity of this M-PESA statement dial *334#, select My account and follow theprompts to enter the code.",,,,,
,,,,,,
LLHKTUZR,,,,,,
